annee,cumul_periode,rss,region,nom_etablissement,nom_installation,no_permis_installation,nb_visites_total,nb_usagers_75ans_et_plus_total,nb_usagers_sante_mentale_total,dms_total,nb_usagers_pec_total,delai_pec_total,nb_visites_ambulatoire,nb_usagers_75ans_et_plus_amb,nb_usagers_sante_mentale_amb,dms_ambulatoire,nb_usagers_pec_ambulatoire,delai_pec_ambulatoire,nb_visites_sur_civiere,nb_usagers_sur_civiere_plus_24h,nb_usagers_sur_civiere_plus_48h,dms_sur_civiere,nb_usagers_pec_sur_civiere,delai_pec_sur_civiere,nb_usagers_75ans_et_plus_civ,nb_usagers_sante_mentale_civ
2020-2021,8,99,Total provincial,Total provincial,Total provincial,,1678250,259412,111405,7.8559174117,1440338,1.860498086,1082564,87321,43941,3.7499447228,849322,2.1993979178,595686,114794,26498,15.317865851,591016,1.3734806738,172091,67464
2021-2022,8,99,Total provincial,Total provincial,Total provincial,,2087097,306326,127300,8.3595220363,1697904,2.5332070512,1416866,112623,53344,4.5908565324,1033743,3.0137961703,670231,142090,35970,16.326467787,664161,1.7851871618,193703,73956
2022-2023,8,99,Total provincial,Total provincial,Total provincial,,2218598,327901,126447,8.9486831097,1757732,2.8342550248,1533043,122398,51849,4.9368651807,1079597,3.3743753708,685555,163264,50083,17.919939089,678135,1.9743785914,205503,74598
2023-2024,8,99,Total provincial,Total provincial,Total provincial,,2165092,349551,126876,8.8369988018,1749569,2.8061661691,1458532,134349,50402,4.9019406431,1050606,3.320795401,706560,158424,41321,16.960029042,698963,2.0326308621,215202,76474
2024-2025,8,99,Total provincial,Total provincial,Total provincial,,2370789,386534,137816,8.8416687719,1900048,3.0193598154,1601270,148639,54276,5.0847942321,1139426,3.5889948606,769519,168404,40155,16.65924117,760622,2.1660358503,237895,83540
2020-2021,8,08,Abitibi-Témiscamingue,Total régional,Total régional,,53950,6467,3301,4.8367153795,46633,1.8949030253,43480,3576,2455,3.4474155678,36198,2.0834434683,10470,987,110,10.606224053,10435,1.2408745674,2891,846
2020-2021,8,01,Bas-Saint-Laurent,Total régional,Total régional,,63137,10996,2854,3.8796540724,55155,1.3125295833,45470,4971,1710,2.5355067322,37670,1.4507495133,17667,196,0,7.3391197179,17485,1.0147460681,6025,1144
2020-2021,8,03,Capitale-Nationale,Total régional,Total régional,,184712,29823,11724,7.273091326,158994,1.4670215648,117686,10417,3826,3.2012906449,92196,1.7995661809,67026,11311,2586,14.422465225,66798,1.0080365139,19406,7898
2020-2021,8,12,Chaudière-Appalaches,Total régional,Total régional,,91614,15490,4585,5.4828224883,79438,0.9016736113,63358,5677,2094,2.3982863166,51204,1.0702000549,28256,3273,202,12.399231137,28234,0.5960411108,9813,2491
2020-2021,8,09,Côte-Nord,Total régional,Total régional,,46920,5426,2575,5.8570451478,38161,1.885359493,36341,2867,1544,3.1473698746,28191,1.9449659466,10579,1763,820,15.165326564,9970,1.7168173131,2559,1031
2020-2021,8,05,Estrie,Total régional,Total régional,,115487,17614,7079,7.3111956492,100028,2.1137644904,71556,5563,2385,3.9832824796,56316,2.6348997275,43931,6206,1128,12.731790554,43712,1.4423641423,12051,4694
2020-2021,8,11,Gaspésie-Îles-de-la-Madeleine,Total régional,Total régional,,44706,7166,1833,4.4995997679,40166,1.1996430992,34747,3939,1217,2.5211683982,30409,1.2810156807,9959,1143,302,11.402356551,9757,0.9460345279,3227,616
2020-2021,8,14,Lanaudière,Total régional,Total régional,,70248,10875,4825,8.9645121727,57044,2.4073542986,43117,3017,2313,4.6986838009,30137,3.033887322,27131,5985,563,15.743831841,26907,1.7056103017,7858,2512
2020-2021,8,15,Laurentides,Total régional,Total régional,,93930,14166,6910,10.376006497,77806,2.7741048998,58630,4677,2435,5.0496170902,42732,3.4748986643,35300,9183,2777,19.222641368,35074,1.9203009668,9489,4475
2020-2021,8,13,Laval,Total régional,Total régional,,44381,7778,3149,8.366527493,35485,2.2177562272,28186,2144,939,4.3044467111,19330,2.8228412657,16195,3019,207,15.436228568,16155,1.4937516593,5634,2210
2020-2021,8,04,Mauricie et Centre-du-Québec,Total régional,Total régional,,117662,19529,7119,6.0592457397,98346,1.923052313,74528,6000,2459,3.2666535471,55622,2.3442836867,43134,3853,185,10.884356115,42724,1.3746548908,13529,4660
2020-2021,8,06,Montréal,Total régional,Total régional,,396087,57475,32788,9.9543627305,359504,1.8015660898,232461,14520,11449,4.5139879605,197272,2.2436999999,163626,41449,10667,17.683421434,162232,1.263937011,42955,21339
2020-2021,8,16,Montérégie,Total régional,Total régional,,191488,32809,13485,9.697546835,156796,2.1925452339,122234,10331,5487,4.1651367391,87747,2.6240823143,69254,19825,5350,19.462305775,69049,1.6441508446,22478,7998
2020-2021,8,07,Outaouais,Total régional,Total régional,,77221,10406,4797,7.4678187173,60133,2.2875263444,54301,4425,2087,3.622086574,37572,2.3003417069,22920,4902,1477,16.578948783,22561,2.2661842585,5981,2710
2020-2021,8,02,Saguenay-Lac-Saint-Jean,Total régional,Total régional,,86707,13392,4381,5.1576862499,76649,1.7292980448,56469,5197,1541,2.8351850229,46726,1.944605995,30238,1699,124,9.4949215759,29923,1.3930857906,8195,2840
2021-2022,8,08,Abitibi-Témiscamingue,Total régional,Total régional,,67383,7292,3978,5.6956453491,55064,2.6817127141,55546,4154,2963,4.4188147661,43324,2.9648412414,11837,1377,194,11.687267513,11740,1.6368864518,3138,1015
2021-2022,8,01,Bas-Saint-Laurent,Total régional,Total régional,,79923,12614,3462,4.1137744906,69433,1.7587521424,60395,6347,2179,3.0197425008,50162,1.9476107357,19528,344,5,7.4973294898,19271,1.2671572714,6267,1283
2021-2022,8,03,Capitale-Nationale,Total régional,Total régional,,225214,34343,12661,7.0239233573,186898,1.8231200084,150654,13352,4308,3.6777422217,112608,2.285593524,74560,11794,2131,13.785130074,74290,1.1221075216,20991,8353
2021-2022,8,12,Chaudière-Appalaches,Total régional,Total régional,,122448,19037,5852,5.7654410239,105461,1.3714323884,89669,7898,2801,2.9568589789,72713,1.6253804761,32779,4981,448,13.448492471,32748,0.8075711663,11139,3051
2021-2022,8,09,Côte-Nord,Total régional,Total régional,,59549,6627,3294,6.5619655708,47634,2.4246173835,46749,3643,2005,3.7605733872,35186,2.5163169932,12800,2362,1137,16.793393945,12448,2.1654157071,2984,1289
2021-2022,8,05,Estrie,Total régional,Total régional,,139425,20700,7661,7.9565099615,115557,2.8977283938,89446,6939,2775,4.8394669596,65895,3.7047243004,49979,8063,1499,13.534993492,49662,1.8269500266,13761,4886
2021-2022,8,11,Gaspésie-Îles-de-la-Madeleine,Total régional,Total régional,,57483,9050,2328,4.7952891435,50720,1.6146635723,46053,5437,1579,2.9988596955,39494,1.7248257541,11430,1454,342,12.033343856,11226,1.227103871,3613,749
2021-2022,8,14,Lanaudière,Total régional,Total régional,,86983,13720,5515,9.932299319,64940,3.4872904433,57443,4320,2980,6.0044600299,35574,4.4904059847,29540,8375,929,17.570311245,29366,2.2721153337,9400,2535
2021-2022,8,15,Laurentides,Total régional,Total régional,,112993,17640,7619,12.110066096,85925,3.7321961821,75027,6372,2817,6.3110584597,48253,4.6589115703,37966,13608,4971,23.569849741,37672,2.545192635,11268,4802
2021-2022,8,13,Laval,Total régional,Total régional,,55756,8940,3498,8.273610578,42666,2.8768544495,37066,2739,1042,4.9177766237,24032,3.6700023233,18690,3029,191,14.92889904,18634,1.8539431207,6201,2456
2021-2022,8,04,Mauricie et Centre-du-Québec,Total régional,Total régional,,148352,23402,8108,6.7461251505,115997,2.8798484372,98862,7810,2901,4.3208025525,67303,3.5258142488,49490,5548,193,11.590987601,48694,1.9870189916,15592,5207
2021-2022,8,06,Montréal,Total régional,Total régional,,514787,69303,38041,10.249200429,436473,2.5528096182,324345,19192,14342,5.544304709,247980,3.2228305733,190442,48795,13418,18.262188122,188493,1.6713349936,50111,23699
2021-2022,8,16,Montérégie,Total régional,Total régional,,228432,37516,14648,10.56639638,167020,3.1958865439,152590,13019,6295,5.2367845643,91569,3.8559943807,75842,23573,7835,21.289286953,75451,2.394765094,24497,8353
2021-2022,8,07,Outaouais,Total régional,Total régional,,84989,10974,5472,8.005325127,65728,2.3408936662,62413,5129,2454,3.8482002503,43516,2.3458892323,22576,5679,2346,19.49800031,22212,2.3311067466,5845,3018
2021-2022,8,02,Saguenay-Lac-Saint-Jean,Total régional,Total régional,,103380,15168,5163,5.8651784275,88388,2.3524153951,70608,6272,1903,3.4759854525,56134,2.6470040488,32772,3108,331,11.01274762,32254,1.8397211715,8896,3260
2022-2023,8,08,Abitibi-Témiscamingue,Total régional,Total régional,,69606,7615,3801,6.0117023955,57867,2.9255767248,57497,4161,2763,4.6968886686,45870,3.2117459245,12109,1518,224,12.254814532,11997,1.8314214202,3454,1038
2022-2023,8,01,Bas-Saint-Laurent,Total régional,Total régional,,86966,13758,3166,4.3313062672,74580,1.9267517468,65667,6640,1916,3.1481276153,53626,2.1010803269,21299,553,24,7.9791673188,20954,1.4806056918,7118,1250
2022-2023,8,03,Capitale-Nationale,Total régional,Total régional,,239331,37334,12767,7.3345995376,194288,1.9629496589,161297,14621,4626,3.7335035921,116677,2.4443680012,78034,13596,3327,14.778098176,77611,1.239206273,22713,8141
2022-2023,8,12,Chaudière-Appalaches,Total régional,Total régional,,149234,22452,6229,6.0998569379,127620,1.7395088675,115856,10459,3292,3.3417522159,94281,2.033244786,33378,7312,1313,15.673317921,33339,0.9088385974,11993,2937
2022-2023,8,09,Côte-Nord,Total régional,Total régional,,62861,6920,3139,6.4516127603,50013,2.8155001311,49998,3898,2033,4.4070100304,37456,2.9492596424,12863,2114,796,14.398907115,12557,2.4165118172,3022,1106
2022-2023,8,05,Estrie,Total régional,Total régional,,147916,22197,7765,8.6526170916,119357,3.30039956,97067,7550,2633,5.3142492471,68799,4.2880109005,50849,10057,2343,15.025315701,50558,1.9564644237,14647,5132
2022-2023,8,11,Gaspésie-Îles-de-la-Madeleine,Total régional,Total régional,,62555,9880,2461,5.425515684,54838,1.9569813765,50976,6063,1670,3.4846327684,43492,2.0972261374,11579,1868,606,13.970160948,11346,1.4193888203,3817,791
2022-2023,8,14,Lanaudière,Total régional,Total régional,,90138,14699,5377,10.747246139,63405,3.960454972,61201,4735,2904,6.3142772858,34607,5.0124088495,28937,9467,2167,20.122859603,28798,2.6963058006,9964,2473
2022-2023,8,15,Laurentides,Total régional,Total régional,,118096,18896,7558,12.318780303,86939,3.9943806897,79087,6791,2600,6.4352781466,48237,4.9450126977,39009,14313,5367,24.24701571,38702,2.8095417621,12105,4958
2022-2023,8,13,Laval,Total régional,Total régional,,58252,9691,3561,9.2484344982,43196,3.2414033257,39028,2839,1061,5.5442282393,24043,4.1745212282,19224,4343,343,16.768605216,19153,2.0700487739,6852,2500
2022-2023,8,04,Mauricie et Centre-du-Québec,Total régional,Total régional,,151252,24082,7774,7.7816000964,115590,3.2297872509,101164,8017,2381,4.8173049729,66325,4.0393684508,50088,8267,1078,13.768661905,49265,2.1398557969,16065,5393
2022-2023,8,06,Montréal,Total régional,Total régional,,540436,72991,37910,11.07900499,437716,2.8577071269,344178,20172,13631,5.9775442568,244351,3.7321970933,196258,54412,18371,20.025445656,193365,1.7526338315,52819,24279
2022-2023,8,16,Montérégie,Total régional,Total régional,,232540,38912,14062,11.578605276,164654,3.6276370686,158777,14056,5790,5.7704278362,91285,4.2651983744,73763,24862,10236,24.080875917,73369,2.8343894598,24856,8272
2022-2023,8,07,Outaouais,Total régional,Total régional,,97501,12136,5442,8.6966010064,72685,2.8923064785,73047,5702,2449,4.3387933948,48719,2.9388600957,24454,6706,3303,21.713889491,23966,2.7976705078,6434,2993
2022-2023,8,02,Saguenay-Lac-Saint-Jean,Total régional,Total régional,,111914,16338,5435,6.2612926444,94984,2.6669541391,78203,6694,2100,3.8217558754,61829,2.9858521621,33711,3876,585,11.920546121,33155,2.0722581394,9644,3335
2023-2024,8,08,Abitibi-Témiscamingue,Total régional,Total régional,,66765,7978,3538,6.143505858,56766,2.788562192,53830,4437,2495,4.8099061294,43976,3.0756284425,12935,1382,237,11.693383971,12790,1.801539093,3541,1043
2023-2024,8,01,Bas-Saint-Laurent,Total régional,Total régional,,82724,14610,3368,4.6098109913,71881,1.9638713754,61617,7280,1962,3.3035745637,51148,2.1511037197,21107,791,62,8.4230658339,20733,1.5019719904,7330,1406
2023-2024,8,03,Capitale-Nationale,Total régional,Total régional,,234466,40043,12849,7.3156720105,193734,1.9638623921,154840,15531,4592,3.7339506031,114595,2.4380738543,79626,13213,2732,14.28065509,79139,1.2771938404,24512,8257
2023-2024,8,12,Chaudière-Appalaches,Total régional,Total régional,,144020,23297,6133,5.7172436988,125249,1.7774519136,112174,11551,3217,3.3192576587,93442,2.0916386963,31846,5437,897,14.163883341,31807,0.8544399556,11746,2916
2023-2024,8,09,Côte-Nord,Total régional,Total régional,,60587,7146,3304,6.1439175254,48472,2.6375604874,47732,4207,2132,3.8759914208,35906,2.7664923767,12855,2194,766,14.564971498,12566,2.2691514139,2939,1172
2023-2024,8,05,Estrie,Total régional,Total régional,,143974,23472,7721,8.6617603082,118418,3.2941973114,94149,8746,2732,5.313375173,68851,4.2361798142,49825,9926,2195,14.988847355,49567,1.9857373017,14726,4989
2023-2024,8,11,Gaspésie-Îles-de-la-Madeleine,Total régional,Total régional,,60859,10216,2393,5.2493566322,54102,1.8216191022,48901,6224,1598,3.3409197381,42317,1.9515039005,11958,1867,423,13.053711253,11785,1.3552351388,3992,795
2023-2024,8,14,Lanaudière,Total régional,Total régional,,89423,16067,5573,10.402449836,64377,4.0660193772,59053,5377,2963,6.2655006661,34186,5.120098749,30370,9080,1266,18.446547937,30191,2.872459793,10690,2610
2023-2024,8,15,Laurentides,Total régional,Total régional,,117370,20774,8038,11.851958084,88656,4.0324490791,76566,7688,2524,6.5870413797,48216,5.052999016,40804,13486,4025,21.731225125,40440,2.8156628338,13086,5514
2023-2024,8,13,Laval,Total régional,Total régional,,56008,10781,3495,9.5397001321,43455,2.9925526471,35912,3374,845,5.4023343791,23405,3.8402116357,20096,4341,470,16.933264967,20050,2.0030534636,7407,2650
2023-2024,8,04,Mauricie et Centre-du-Québec,Total régional,Total régional,,146056,25433,7435,7.3222509878,115150,2.972386959,95420,8670,2342,4.5041332763,65373,3.6796061957,50636,6877,658,12.632796687,49777,2.043583633,16763,5093
2023-2024,8,06,Montréal,Total régional,Total régional,,526172,76024,37986,10.969996906,434193,2.6877321241,324258,21804,13126,5.6961162151,234758,3.4823535466,201914,54856,16247,19.439434415,199435,1.7523710496,54220,24860
2023-2024,8,16,Montérégie,Total régional,Total régional,,232410,43322,14081,11.124851037,170757,3.7510252646,149623,15797,5372,6.0397114767,88635,4.4457170637,82787,24510,7822,20.315349984,82122,3.0012382695,27525,8709
2023-2024,8,07,Outaouais,Total régional,Total régional,,95580,12977,5281,9.6626383309,71052,3.4485414008,70525,6113,2271,5.096410863,46633,3.4123098569,25055,7505,3324,22.515689306,24419,3.5177328333,6864,3010
2023-2024,8,02,Saguenay-Lac-Saint-Jean,Total régional,Total régional,,108678,17411,5681,6.0520107105,93307,2.6410851693,73932,7550,2231,3.7843402421,59165,2.9640758566,34746,2959,197,10.877124769,34142,2.0813715024,9861,3450
2024-2025,8,08,Abitibi-Témiscamingue,Total régional,Total régional,,76204,9307,4078,6.2319589596,63833,3.1940981546,61975,5221,2957,5.0436956434,49772,3.5202175866,14229,1550,190,11.407489146,14061,2.0397267462,4086,1121
2024-2025,8,01,Bas-Saint-Laurent,Total régional,Total régional,,94004,16110,3751,4.7280892007,81189,2.0713425498,72564,8376,2277,3.3758060892,60072,2.2776450667,21440,1279,120,9.3049115749,21117,1.4844691875,7734,1474
2024-2025,8,03,Capitale-Nationale,Total régional,Total régional,,258234,44159,13958,7.2190849718,211768,2.1054183325,172489,17192,5162,3.8880229818,126667,2.5864305445,85745,14307,1996,13.920018573,85101,1.3894646557,26967,8796
2024-2025,8,12,Chaudière-Appalaches,Total régional,Total régional,,156303,25619,6718,6.259219989,135100,2.0521798524,122067,13024,3447,3.6237668225,100926,2.4175799541,34236,6629,1705,15.655816019,34174,0.9730445254,12595,3271
2024-2025,8,09,Côte-Nord,Total régional,Total régional,,66120,8000,3653,6.472780853,52891,3.2143764745,52374,4653,2180,4.6583120866,39492,3.421399735,13746,2068,577,13.386136533,13399,2.6041994013,3347,1473
2024-2025,8,05,Estrie,Total régional,Total régional,,155937,25667,7868,8.784674117,126348,3.789660134,103044,9497,2891,5.9808822364,73853,4.8959953857,52893,9144,1306,14.246907882,52495,2.2332037601,16170,4977
2024-2025,8,11,Gaspésie-Îles-de-la-Madeleine,Total régional,Total régional,,66961,11257,2565,5.0042240716,58581,2.0554710145,53967,7125,1634,3.5644418657,45793,2.2152745689,12994,1373,198,10.983962897,12788,1.4832248332,4132,931
2024-2025,8,14,Lanaudière,Total régional,Total régional,,98397,17940,6230,10.028991706,72579,3.5273253972,64977,5884,3227,5.7885358665,39327,4.4290226887,33420,9871,1306,18.273518909,33252,2.4608918177,12056,3003
2024-2025,8,15,Laurentides,Total régional,Total régional,,130139,23248,8555,11.705004728,99539,3.8265685477,84860,8536,2730,6.2717825634,54610,4.7797035036,45279,14539,4589,21.887721503,44929,2.6680584552,14712,5825
2024-2025,8,13,Laval,Total régional,Total régional,,58946,11323,3903,10.652122286,45276,3.7998543747,37017,3515,826,6.5310918332,23453,4.889410535,21929,5461,502,17.608581052,21823,2.6289172611,7808,3077
2024-2025,8,04,Mauricie et Centre-du-Québec,Total régional,Total régional,,161301,28898,8193,7.2818441144,126523,3.2099151384,105033,10272,2474,4.8790682452,71314,4.0283303029,56268,6212,408,11.767000116,55209,2.152760344,18626,5719
2024-2025,8,06,Montréal,Total régional,Total régional,,579261,84734,40963,10.736140861,468460,2.7826522453,357496,23806,14117,5.6996540894,249190,3.644958209,221765,57799,16399,18.855203268,219270,1.8026822398,60928,26846
2024-2025,8,16,Montérégie,Total régional,Total régional,,242641,45959,15728,11.420864648,176657,4.0768488134,152043,16219,5721,6.1704043209,87010,4.9417000664,90598,26896,8291,20.232270414,89647,3.2374374832,29740,10007
2024-2025,8,07,Outaouais,Total régional,Total régional,,106616,15017,5954,9.3941063854,79478,4.1913953477,78620,6910,2470,5.5271062495,52460,4.0509137014,27996,7933,2360,20.253641701,27018,4.4641641375,8107,3484
2024-2025,8,02,Saguenay-Lac-Saint-Jean,Total régional,Total régional,,119725,19296,5699,6.3693536878,101826,2.9516912538,82744,8409,2163,4.1826356896,65487,3.3545928199,36981,3343,208,11.262076817,36339,2.2256169298,10887,3536
2020-2021,8,01,Bas-Saint-Laurent,CISSS DU BAS-SAINT-LAURENT,Total établissement,,63137,10996,2854,3.8796540724,55155,1.3125295833,45470,4971,1710,2.5355067322,37670,1.4507495133,17667,196,0,7.3391197179,17485,1.0147460681,6025,1144
2020-2021,8,02,Saguenay-Lac-Saint-Jean,CIUSSS DU SAGUENAY - LAC-SAINT-JEAN,Total établissement,,86707,13392,4381,5.1576862499,76649,1.7292980448,56469,5197,1541,2.8351850229,46726,1.944605995,30238,1699,124,9.4949215759,29923,1.3930857906,8195,2840
2020-2021,8,03,Capitale-Nationale,CHU DE QUÉBEC - UNIVERSITÉ LAVAL,Total établissement,,118840,19386,10105,8.9987272336,104146,1.5259798477,67856,5384,2803,3.7327422737,53295,2.0035663915,50984,10445,2537,16.00737064,50851,1.0254395467,14002,7302
2020-2021,8,03,Capitale-Nationale,CIUSSS DE LA CAPITALE-NATIONALE,Total établissement,,52096,6299,1246,3.2703773749,41699,1.318288215,43025,3741,812,2.2851993802,32716,1.4472615591,9071,385,49,7.9432120371,8983,0.8485685307,2558,434
2020-2021,8,03,Capitale-Nationale,INSTITUT UNIVERSITAIRE DE CARDIOLOGIE ET DE PNEUMOLOGIE DE QUÉBEC - UNIVERSITÉ LAVAL,Total établissement,,13776,4138,373,7.5235860071,13149,1.4717186985,6805,1292,211,3.6939644053,6185,1.905274634,6971,481,0,11.262013062,6964,1.0866607633,2846,162
2020-2021,8,04,Mauricie et Centre-du-Québec,CIUSSS DE LA MAURICIE-ET-DU-CENTRE-DU-QUÉBEC,Total établissement,,117662,19529,7119,6.0592457397,98346,1.923052313,74528,6000,2459,3.2666535471,55622,2.3442836867,43134,3853,185,10.884356115,42724,1.3746548908,13529,4660
2020-2021,8,05,Estrie,CIUSSS DE L'ESTRIE - CENTRE HOSPITALIER UNIVERSITAIRE DE SHERBROOKE,Total établissement,,115487,17614,7079,7.3111956492,100028,2.1137644904,71556,5563,2385,3.9832824796,56316,2.6348997275,43931,6206,1128,12.731790554,43712,1.4423641423,12051,4694
2020-2021,8,06,Montréal,CENTRE HOSPITALIER DE L'UNIVERSITÉ DE MONTRÉAL,Total établissement,,32083,4579,2431,12.331034651,27985,2.1884901138,19053,1296,999,5.8164455,15018,2.9235622808,13030,4866,956,21.856933892,12967,1.3371510372,3283,1432
2020-2021,8,06,Montréal,CENTRE HOSPITALIER UNIVERSITAIRE SAINTE-JUSTINE,Total établissement,,29115,0,838,4.2157942832,27871,1.084297966,19972,0,411,3.4393042343,18814,1.2282565288,9143,17,0,5.9119617619,9057,0.78525453,0,427
2020-2021,8,06,Montréal,CENTRE UNIVERSITAIRE DE SANTÉ MCGILL,Total établissement,,71151,7709,3929,9.689415816,65797,1.6409257556,39406,1663,1014,4.6247805749,34338,1.9461134975,31745,6339,1938,15.976296153,31459,1.3078084703,6046,2915
2020-2021,8,06,Montréal,CIUSSS DE L'EST-DE-L'ÎLE-DE-MONTRÉAL,Total établissement,,55006,11152,6288,13.267269959,47123,2.5549075705,30702,2600,2239,5.042520547,22952,3.4546111934,24304,9267,3027,23.657175179,24171,1.7005781032,8552,4049
2020-2021,8,06,Montréal,CIUSSS DE L'OUEST-DE-L'ÎLE-DE-MONTRÉAL,Total établissement,,55461,9063,6310,10.039821797,52080,1.9596942098,35199,2584,2092,4.837661818,31876,2.2776340873,20262,5742,1152,19.076976524,20204,1.4580781171,6479,4218
2020-2021,8,06,Montréal,CIUSSS DU CENTRE-OUEST-DE-L'ÎLE-DE-MONTRÉAL,Total établissement,,38652,7201,2112,8.1398282323,36495,1.1804388272,15244,841,248,3.2616554236,13305,1.3154567205,23408,2402,363,11.316642411,23190,1.1029738393,6360,1864
2020-2021,8,06,Montréal,CIUSSS DU CENTRE-SUD-DE-L'ÎLE-DE-MONTRÉAL,Total établissement,,39324,5287,4634,11.055326688,35202,1.6596138004,22490,1345,1550,4.1263304679,18864,2.128928117,16834,5614,1615,20.312373437,16338,1.1177393194,3942,3084
2020-2021,8,06,Montréal,CIUSSS DU NORD-DE-L'ÎLE-DE-MONTRÉAL,Total établissement,,65467,9881,5900,9.4038381296,57339,1.9801707535,44224,3018,2597,4.5391555804,36148,2.5409358978,21243,6217,1509,19.531208137,21191,1.0236071917,6863,3303
2020-2021,8,06,Montréal,INSTITUT DE CARDIOLOGIE DE MONTRÉAL,Total établissement,,9828,2603,346,8.4883215755,9612,1.1171685856,6171,1173,299,3.1135543042,5957,1.2380328465,3657,985,107,17.557965773,3655,0.9201813345,1430,47
2020-2021,8,07,Outaouais,CISSS DE L'OUTAOUAIS,Total établissement,,77221,10406,4797,7.4678187173,60133,2.2875263444,54301,4425,2087,3.622086574,37572,2.3003417069,22920,4902,1477,16.578948783,22561,2.2661842585,5981,2710
2020-2021,8,08,Abitibi-Témiscamingue,CISSS DE L'ABITIBI-TÉMISCAMINGUE,Total établissement,,53950,6467,3301,4.8367153795,46633,1.8949030253,43480,3576,2455,3.4474155678,36198,2.0834434683,10470,987,110,10.606224053,10435,1.2408745674,2891,846
2020-2021,8,09,Côte-Nord,CISSS DE LA CÔTE-NORD,Total établissement,,46920,5426,2575,5.8570451478,38161,1.885359493,36341,2867,1544,3.1473698746,28191,1.9449659466,10579,1763,820,15.165326564,9970,1.7168173131,2559,1031
2020-2021,8,11,Gaspésie-Îles-de-la-Madeleine,CISSS DE LA GASPÉSIE,Total établissement,,37943,6397,1656,4.6914675815,34363,1.2728990969,29257,3484,1123,2.6637210468,25868,1.3641563364,8686,1038,293,11.521513675,8495,0.9950130142,2913,533
2020-2021,8,11,Gaspésie-Îles-de-la-Madeleine,CISSS DES ÎLES,Total établissement,,6763,769,177,3.423148422,5803,0.7658509487,5490,455,94,1.7614848209,4541,0.8074013923,1273,105,9,10.589317448,1262,0.6163417855,314,83
2020-2021,8,12,Chaudière-Appalaches,CISSS DE CHAUDIÈRE-APPALACHES,Total établissement,,91614,15490,4585,5.4828224883,79438,0.9016736113,63358,5677,2094,2.3982863166,51204,1.0702000549,28256,3273,202,12.399231137,28234,0.5960411108,9813,2491
2020-2021,8,13,Laval,CISSS DE LAVAL,Total établissement,,44381,7778,3149,8.366527493,35485,2.2177562272,28186,2144,939,4.3044467111,19330,2.8228412657,16195,3019,207,15.436228568,16155,1.4937516593,5634,2210
2020-2021,8,14,Lanaudière,CISSS DE LANAUDIÈRE,Total établissement,,70248,10875,4825,8.9645121727,57044,2.4073542986,43117,3017,2313,4.6986838009,30137,3.033887322,27131,5985,563,15.743831841,26907,1.7056103017,7858,2512
2020-2021,8,15,Laurentides,CISSS DES LAURENTIDES,Total établissement,,93930,14166,6910,10.376006497,77806,2.7741048998,58630,4677,2435,5.0496170902,42732,3.4748986643,35300,9183,2777,19.222641368,35074,1.9203009668,9489,4475
2020-2021,8,16,Montérégie,CISSS DE LA MONTÉRÉGIE-CENTRE,Total établissement,,69002,11690,5751,9.2987244613,53379,2.3298260812,44671,3558,2140,4.0957338094,29101,2.7968427106,24331,6973,1410,18.851262187,24278,1.7700332262,8132,3611
2020-2021,8,16,Montérégie,CISSS DE LA MONTÉRÉGIE-EST,Total établissement,,71022,12393,4519,9.1243900364,58866,2.1296904552,43609,4232,1716,3.9648877589,31562,2.5542515085,27413,7010,1694,17.33220147,27304,1.6389200199,8161,2803
2020-2021,8,16,Montérégie,CISSS DE LA MONTÉRÉGIE-OUEST,Total établissement,,51464,8726,3215,11.023255749,44551,2.1111126075,33954,2541,1631,4.5136363577,27084,2.519832558,17510,5842,2246,23.646192176,17467,1.4773591789,6185,1584
2021-2022,8,01,Bas-Saint-Laurent,CISSS DU BAS-SAINT-LAURENT,Total établissement,,79923,12614,3462,4.1137744906,69433,1.7587521424,60395,6347,2179,3.0197425008,50162,1.9476107357,19528,344,5,7.4973294898,19271,1.2671572714,6267,1283
2021-2022,8,02,Saguenay-Lac-Saint-Jean,CIUSSS DU SAGUENAY - LAC-SAINT-JEAN,Total établissement,,103380,15168,5163,5.8651784275,88388,2.3524153951,70608,6272,1903,3.4759854525,56134,2.6470040488,32772,3108,331,11.01274762,32254,1.8397211715,8896,3260
2021-2022,8,03,Capitale-Nationale,CHU DE QUÉBEC - UNIVERSITÉ LAVAL,Total établissement,,143983,21811,10860,8.4610599766,120696,1.8282064949,87303,6899,3200,4.11780943,64170,2.4558029453,56680,10827,2107,15.150876534,56526,1.1157402985,14912,7660
2021-2022,8,03,Capitale-Nationale,CIUSSS DE LA CAPITALE-NATIONALE,Total établissement,,64610,7570,1410,3.7111522124,50463,1.8330667189,54643,4736,888,2.9463142631,40599,2.034200425,9967,350,24,7.9042935855,9864,1.0052253424,2834,522
2021-2022,8,03,Capitale-Nationale,INSTITUT UNIVERSITAIRE DE CARDIOLOGIE ET DE PNEUMOLOGIE DE QUÉBEC - UNIVERSITÉ LAVAL,Total établissement,,16621,4962,391,7.4519903703,15739,1.7522222752,8708,1717,220,3.8555362566,7839,2.1942514989,7913,617,0,11.409771543,7900,1.3136061885,3245,171
2021-2022,8,04,Mauricie et Centre-du-Québec,CIUSSS DE LA MAURICIE-ET-DU-CENTRE-DU-QUÉBEC,Total établissement,,148352,23402,8108,6.7461251505,115997,2.8798484372,98862,7810,2901,4.3208025525,67303,3.5258142488,49490,5548,193,11.590987601,48694,1.9870189916,15592,5207
2021-2022,8,05,Estrie,CIUSSS DE L'ESTRIE - CENTRE HOSPITALIER UNIVERSITAIRE DE SHERBROOKE,Total établissement,,139425,20700,7661,7.9565099615,115557,2.8977283938,89446,6939,2775,4.8394669596,65895,3.7047243004,49979,8063,1499,13.534993492,49662,1.8269500266,13761,4886
2021-2022,8,06,Montréal,CENTRE HOSPITALIER DE L'UNIVERSITÉ DE MONTRÉAL,Total établissement,,38932,5675,3064,13.100367057,31445,2.9683688009,23737,1703,1118,6.9727193949,16371,4.2578515363,15195,5638,1394,22.67272458,15074,1.5679361446,3972,1946
2021-2022,8,06,Montréal,CENTRE HOSPITALIER UNIVERSITAIRE SAINTE-JUSTINE,Total établissement,,52019,1,1416,5.4357536456,45347,2.0292261708,36200,1,715,4.7610315838,30025,2.3674608197,15819,211,0,6.9797790983,15322,1.3664213585,0,701
2021-2022,8,06,Montréal,CENTRE UNIVERSITAIRE DE SANTÉ MCGILL,Total établissement,,105226,9472,5103,10.231309084,90351,2.5709715074,69406,2617,1458,6.0028511584,54849,3.1158852942,35820,8078,3103,18.424507041,35502,1.7291041115,6855,3645
2021-2022,8,06,Montréal,CIUSSS DE L'EST-DE-L'ÎLE-DE-MONTRÉAL,Total établissement,,63307,11918,6895,12.533770015,49288,3.3464265925,36412,2756,2430,5.6493117272,22667,4.5428734749,26895,9299,2715,21.854346151,26621,2.3276871956,9162,4465
2021-2022,8,06,Montréal,CIUSSS DE L'OUEST-DE-L'ÎLE-DE-MONTRÉAL,Total établissement,,64524,10893,7124,11.142845806,56061,2.7457332093,43118,3554,2926,6.1082179716,34728,3.3548939616,21406,6604,2100,21.284071769,21333,1.7540801549,7339,4198
2021-2022,8,06,Montréal,CIUSSS DU CENTRE-OUEST-DE-L'ÎLE-DE-MONTRÉAL,Total établissement,,53019,9169,2723,9.0635577707,48094,1.8948504029,22635,1354,392,4.0598334438,18251,2.1226946012,30384,4067,771,12.791154537,29843,1.7555083641,7815,2331
2021-2022,8,06,Montréal,CIUSSS DU CENTRE-SUD-DE-L'ÎLE-DE-MONTRÉAL,Total établissement,,45316,6445,4872,10.914215423,39438,2.1521871883,29680,1930,2053,4.8516226789,23867,2.741176741,15636,5637,1415,22.42213002,15571,1.2493926566,4515,2819
2021-2022,8,06,Montréal,CIUSSS DU NORD-DE-L'ÎLE-DE-MONTRÉAL,Total établissement,,81523,12831,6500,10.028873556,65840,2.8291262066,56484,4118,2957,5.580993895,40858,3.7515554141,25039,8018,1810,20.06258236,24982,1.3204954901,8713,3543
2021-2022,8,06,Montréal,INSTITUT DE CARDIOLOGIE DE MONTRÉAL,Total établissement,,10921,2899,344,9.3031660715,10609,1.4551007007,6673,1159,293,3.5319359109,6364,1.6621540436,4248,1243,110,18.36894264,4245,1.1446914016,1740,51
2021-2022,8,07,Outaouais,CISSS DE L'OUTAOUAIS,Total établissement,,84989,10974,5472,8.005325127,65728,2.3408936662,62413,5129,2454,3.8482002503,43516,2.3458892323,22576,5679,2346,19.49800031,22212,2.3311067466,5845,3018
2021-2022,8,08,Abitibi-Témiscamingue,CISSS DE L'ABITIBI-TÉMISCAMINGUE,Total établissement,,67383,7292,3978,5.6956453491,55064,2.6817127141,55546,4154,2963,4.4188147661,43324,2.9648412414,11837,1377,194,11.687267513,11740,1.6368864518,3138,1015
2021-2022,8,09,Côte-Nord,CISSS DE LA CÔTE-NORD,Total établissement,,59549,6627,3294,6.5619655708,47634,2.4246173835,46749,3643,2005,3.7605733872,35186,2.5163169932,12800,2362,1137,16.793393945,12448,2.1654157071,2984,1289
2021-2022,8,11,Gaspésie-Îles-de-la-Madeleine,CISSS DE LA GASPÉSIE,Total établissement,,47652,7828,2028,5.0918626244,42163,1.7287441793,37862,4611,1412,3.1666269097,32570,1.8529850152,9790,1371,340,12.537549512,9593,1.3069236828,3217,616
2021-2022,8,11,Gaspésie-Îles-de-la-Madeleine,CISSS DES ÎLES,Total établissement,,9831,1222,300,3.3577630003,8557,1.0525529456,8191,826,167,2.2233741301,6924,1.1219737708,1640,83,2,9.0234820461,1633,0.758205246,396,133
2021-2022,8,12,Chaudière-Appalaches,CISSS DE CHAUDIÈRE-APPALACHES,Total établissement,,122448,19037,5852,5.7654410239,105461,1.3714323884,89669,7898,2801,2.9568589789,72713,1.6253804761,32779,4981,448,13.448492471,32748,0.8075711663,11139,3051
2021-2022,8,13,Laval,CISSS DE LAVAL,Total établissement,,55756,8940,3498,8.273610578,42666,2.8768544495,37066,2739,1042,4.9177766237,24032,3.6700023233,18690,3029,191,14.92889904,18634,1.8539431207,6201,2456
2021-2022,8,14,Lanaudière,CISSS DE LANAUDIÈRE,Total établissement,,86983,13720,5515,9.932299319,64940,3.4872904433,57443,4320,2980,6.0044600299,35574,4.4904059847,29540,8375,929,17.570311245,29366,2.2721153337,9400,2535
2021-2022,8,15,Laurentides,CISSS DES LAURENTIDES,Total établissement,,112993,17640,7619,12.110066096,85925,3.7321961821,75027,6372,2817,6.3110584597,48253,4.6589115703,37966,13608,4971,23.569849741,37672,2.545192635,11268,4802
2021-2022,8,16,Montérégie,CISSS DE LA MONTÉRÉGIE-CENTRE,Total établissement,,85569,13179,6389,9.4344104271,55838,3.694967346,60855,4958,2741,5.2789950566,31177,4.4015731683,24714,7661,1663,19.666578525,24661,2.8016601111,8221,3648
2021-2022,8,16,Montérégie,CISSS DE LA MONTÉRÉGIE-EST,Total établissement,,84614,14508,4864,10.146289982,64424,3.1930580563,52622,5047,1835,4.8163243933,32686,3.8660786643,31992,8912,3077,18.913277017,31738,2.499934621,9461,3029
2021-2022,8,16,Montérégie,CISSS DE LA MONTÉRÉGIE-OUEST,Total établissement,,58249,9829,3395,12.839564823,46758,2.603785698,39113,3014,1719,5.7367905882,27706,3.2301687561,19136,7000,3095,27.357270125,19052,1.6928803334,6815,1676
2022-2023,8,01,Bas-Saint-Laurent,CISSS DU BAS-SAINT-LAURENT,Total établissement,,86966,13758,3166,4.3313062672,74580,1.9267517468,65667,6640,1916,3.1481276153,53626,2.1010803269,21299,553,24,7.9791673188,20954,1.4806056918,7118,1250
2022-2023,8,02,Saguenay-Lac-Saint-Jean,CIUSSS DU SAGUENAY - LAC-SAINT-JEAN,Total établissement,,111914,16338,5435,6.2612926444,94984,2.6669541391,78203,6694,2100,3.8217558754,61829,2.9858521621,33711,3876,585,11.920546121,33155,2.0722581394,9644,3335
2022-2023,8,03,Capitale-Nationale,CHU DE QUÉBEC - UNIVERSITÉ LAVAL,Total établissement,,142685,23028,10884,9.1661625064,119112,1.9201887952,84903,7195,3473,4.2313897919,61528,2.5693018716,57782,12140,3223,16.417157761,57584,1.2266171545,15833,7411
2022-2023,8,03,Capitale-Nationale,CIUSSS DE LA CAPITALE-NATIONALE,Total établissement,,79833,8963,1496,3.8867925371,59310,2.0537565241,67828,5655,957,3.0801139934,47505,2.2824720848,12005,593,104,8.4445095099,11805,1.1333725587,3308,539
2022-2023,8,03,Capitale-Nationale,INSTITUT UNIVERSITAIRE DE CARDIOLOGIE ET DE PNEUMOLOGIE DE QUÉBEC - UNIVERSITÉ LAVAL,Total établissement,,16813,5343,387,8.1620672165,15866,1.9445188523,8566,1771,196,3.9723639323,7644,2.4448826967,8247,863,0,12.513831292,8222,1.4793301846,3572,191
2022-2023,8,04,Mauricie et Centre-du-Québec,CIUSSS DE LA MAURICIE-ET-DU-CENTRE-DU-QUÉBEC,Total établissement,,151252,24082,7774,7.7816000964,115590,3.2297872509,101164,8017,2381,4.8173049729,66325,4.0393684508,50088,8267,1078,13.768661905,49265,2.1398557969,16065,5393
2022-2023,8,05,Estrie,CIUSSS DE L'ESTRIE - CENTRE HOSPITALIER UNIVERSITAIRE DE SHERBROOKE,Total établissement,,147916,22197,7765,8.6526170916,119357,3.30039956,97067,7550,2633,5.3142492471,68799,4.2880109005,50849,10057,2343,15.025315701,50558,1.9564644237,14647,5132
2022-2023,8,06,Montréal,CENTRE HOSPITALIER DE L'UNIVERSITÉ DE MONTRÉAL,Total établissement,,41436,5730,3326,13.925633608,31876,3.1184813374,25234,1594,1236,7.4434561945,15805,4.8737524166,16202,6546,1855,24.021378876,16071,1.3922627196,4136,2090
2022-2023,8,06,Montréal,CENTRE HOSPITALIER UNIVERSITAIRE SAINTE-JUSTINE,Total établissement,,57639,0,1155,6.2530935458,45380,2.9682232567,39291,0,576,5.6645364644,27979,3.6772012541,18348,357,5,7.5134486956,17401,1.8282603011,0,579
2022-2023,8,06,Montréal,CENTRE UNIVERSITAIRE DE SANTÉ MCGILL,Total établissement,,110275,8876,4773,11.597827822,89143,3.0644910705,75605,2552,1413,6.9834454548,54867,3.8361875434,34670,9068,4204,21.660428885,34276,1.8292048534,6324,3360
2022-2023,8,06,Montréal,CIUSSS DE L'EST-DE-L'ÎLE-DE-MONTRÉAL,Total établissement,,65927,13014,6614,13.574848018,49521,3.225290466,39173,3268,2186,5.5023339701,23060,4.4585839838,26754,10078,4309,25.394560689,26461,2.1505106572,9746,4428
2022-2023,8,06,Montréal,CIUSSS DE L'OUEST-DE-L'ÎLE-DE-MONTRÉAL,Total établissement,,64666,11611,7031,11.808209745,54551,2.695369099,43878,3752,2704,6.000972678,33850,3.2956669621,20788,7009,2667,24.06575968,20701,1.7137700138,7859,4327
2022-2023,8,06,Montréal,CIUSSS DU CENTRE-OUEST-DE-L'ÎLE-DE-MONTRÉAL,Total établissement,,54431,10095,2902,10.099069985,47522,2.3350205753,21457,1405,345,4.1639431706,15433,2.8113729058,32974,4996,1198,13.961204274,32089,2.1059219584,8690,2557
2022-2023,8,06,Montréal,CIUSSS DU CENTRE-SUD-DE-L'ÎLE-DE-MONTRÉAL,Total établissement,,48465,6913,5028,10.746921834,42131,2.2171720678,31376,1815,1857,4.8691890741,25098,2.8867828114,17089,5672,1406,21.538644173,17033,1.2305055709,5098,3171
2022-2023,8,06,Montréal,CIUSSS DU NORD-DE-L'ÎLE-DE-MONTRÉAL,Total établissement,,86397,13617,6743,10.847165337,66693,3.2820330428,61334,4528,3031,6.0840579541,41723,4.3584232451,25063,9449,2572,22.503408732,24970,1.4834656254,9089,3712
2022-2023,8,06,Montréal,INSTITUT DE CARDIOLOGIE DE MONTRÉAL,Total établissement,,11200,3135,338,9.3611410218,10899,1.2444884852,6830,1258,283,3.6351002115,6536,1.4552875952,4370,1237,155,18.310536613,4363,0.9287004991,1877,55
2022-2023,8,07,Outaouais,CISSS DE L'OUTAOUAIS,Total établissement,,97501,12136,5442,8.6966010064,72685,2.8923064785,73047,5702,2449,4.3387933948,48719,2.9388600957,24454,6706,3303,21.713889491,23966,2.7976705078,6434,2993
2022-2023,8,08,Abitibi-Témiscamingue,CISSS DE L'ABITIBI-TÉMISCAMINGUE,Total établissement,,69606,7615,3801,6.0117023955,57867,2.9255767248,57497,4161,2763,4.6968886686,45870,3.2117459245,12109,1518,224,12.254814532,11997,1.8314214202,3454,1038
2022-2023,8,09,Côte-Nord,CISSS DE LA CÔTE-NORD,Total établissement,,62861,6920,3139,6.4516127603,50013,2.8155001311,49998,3898,2033,4.4070100304,37456,2.9492596424,12863,2114,796,14.398907115,12557,2.4165118172,3022,1106
2022-2023,8,11,Gaspésie-Îles-de-la-Madeleine,CISSS DE LA GASPÉSIE,Total établissement,,51373,8533,2163,5.6036423586,45080,1.9391193496,41479,5144,1487,3.4858772244,35406,2.0798214286,9894,1702,593,14.482031282,9674,1.4241619576,3389,676
2022-2023,8,11,Gaspésie-Îles-de-la-Madeleine,CISSS DES ÎLES,Total établissement,,11182,1347,298,4.6071556718,9758,2.039500353,9497,919,183,3.4791974951,8086,2.1734357738,1685,166,13,10.964555556,1672,1.3917719963,428,115
2022-2023,8,12,Chaudière-Appalaches,CISSS DE CHAUDIÈRE-APPALACHES,Total établissement,,149234,22452,6229,6.0998569379,127620,1.7395088675,115856,10459,3292,3.3417522159,94281,2.033244786,33378,7312,1313,15.673317921,33339,0.9088385974,11993,2937
2022-2023,8,13,Laval,CISSS DE LAVAL,Total établissement,,58252,9691,3561,9.2484344982,43196,3.2414033257,39028,2839,1061,5.5442282393,24043,4.1745212282,19224,4343,343,16.768605216,19153,2.0700487739,6852,2500
2022-2023,8,14,Lanaudière,CISSS DE LANAUDIÈRE,Total établissement,,90138,14699,5377,10.747246139,63405,3.960454972,61201,4735,2904,6.3142772858,34607,5.0124088495,28937,9467,2167,20.122859603,28798,2.6963058006,9964,2473
2022-2023,8,15,Laurentides,CISSS DES LAURENTIDES,Total établissement,,118096,18896,7558,12.318780303,86939,3.9943806897,79087,6791,2600,6.4352781466,48237,4.9450126977,39009,14313,5367,24.24701571,38702,2.8095417621,12105,4958
2022-2023,8,16,Montérégie,CISSS DE LA MONTÉRÉGIE-CENTRE,Total établissement,,87443,13478,6023,10.082867643,54442,4.1610928807,62921,5100,2440,5.6580716383,30005,4.815086967,24522,7667,2365,21.436451746,24437,3.358085451,8378,3583
2022-2023,8,16,Montérégie,CISSS DE LA MONTÉRÉGIE-EST,Total établissement,,84574,15178,4880,11.68417272,63852,4.0021875022,53157,5434,1835,5.8519950336,32694,4.8389676495,31417,9556,3873,21.552112665,31158,3.1241564945,9744,3045
2022-2023,8,16,Montérégie,CISSS DE LA MONTÉRÉGIE-OUEST,Total établissement,,60523,10256,3159,13.592112948,46360,2.4853118828,42699,3522,1515,5.8344503384,28586,3.0317897164,17824,7639,3998,32.17629359,17774,1.6064092526,6734,1644
2023-2024,8,01,Bas-Saint-Laurent,CISSS DU BAS-SAINT-LAURENT,Total établissement,,82724,14610,3368,4.6098109913,71881,1.9638713754,61617,7280,1962,3.3035745637,51148,2.1511037197,21107,791,62,8.4230658339,20733,1.5019719904,7330,1406
2023-2024,8,02,Saguenay-Lac-Saint-Jean,CIUSSS DU SAGUENAY - LAC-SAINT-JEAN,Total établissement,,108678,17411,5681,6.0520107105,93307,2.6410851693,73932,7550,2231,3.7843402421,59165,2.9640758566,34746,2959,197,10.877124769,34142,2.0813715024,9861,3450
2023-2024,8,03,Capitale-Nationale,CHU DE QUÉBEC - UNIVERSITÉ LAVAL,Total établissement,,143476,25032,10985,8.9678786483,121077,1.9860421353,84066,7653,3450,4.2771106432,61960,2.6548214798,59410,11496,2548,15.605382488,59117,1.285100474,17379,7535
2023-2024,8,03,Capitale-Nationale,CIUSSS DE LA CAPITALE-NATIONALE,Total établissement,,73261,8992,1418,3.9093853862,55972,1.8828630089,61513,5765,885,2.9372893896,44396,2.0939498366,11748,762,180,8.9993190803,11576,1.0733078256,3227,533
2023-2024,8,03,Capitale-Nationale,INSTITUT UNIVERSITAIRE DE CARDIOLOGIE ET DE PNEUMOLOGIE DE QUÉBEC - UNIVERSITÉ LAVAL,Total établissement,,17729,6019,446,8.0205039139,16685,2.0746349848,9261,2113,257,4.095005489,8239,2.662378626,8468,955,4,12.313612194,8446,1.5012961428,3906,189
2023-2024,8,04,Mauricie et Centre-du-Québec,CIUSSS DE LA MAURICIE-ET-DU-CENTRE-DU-QUÉBEC,Total établissement,,146056,25433,7435,7.3222509878,115150,2.972386959,95420,8670,2342,4.5041332763,65373,3.6796061957,50636,6877,658,12.632796687,49777,2.043583633,16763,5093
2023-2024,8,05,Estrie,CIUSSS DE L'ESTRIE - CENTRE HOSPITALIER UNIVERSITAIRE DE SHERBROOKE,Total établissement,,143974,23472,7721,8.6617603082,118418,3.2941973114,94149,8746,2732,5.313375173,68851,4.2361798142,49825,9926,2195,14.988847355,49567,1.9857373017,14726,4989
2023-2024,8,06,Montréal,CENTRE HOSPITALIER DE L'UNIVERSITÉ DE MONTRÉAL,Total établissement,,44858,6641,3397,12.685034566,33660,3.1994875223,26329,1850,1012,7.5201118011,15276,5.26367941,18529,6010,998,20.024192182,18384,1.4842680229,4791,2385
2023-2024,8,06,Montréal,CENTRE HOSPITALIER UNIVERSITAIRE SAINTE-JUSTINE,Total établissement,,47349,0,1092,5.1558165959,41275,1.9357292886,30040,0,464,4.3772348258,24463,2.4885113573,17309,247,3,6.5070556262,16812,1.1313807433,0,628
2023-2024,8,06,Montréal,CENTRE UNIVERSITAIRE DE SANTÉ MCGILL,Total établissement,,102958,8750,4866,11.184534292,88562,2.4957447858,68793,2641,1434,5.8660373148,54792,2.9102139911,34165,9094,4030,21.893603883,33770,1.8232663524,6109,3432
2023-2024,8,06,Montréal,CIUSSS DE L'EST-DE-L'ÎLE-DE-MONTRÉAL,Total établissement,,64382,12376,6409,12.207387693,50174,3.0826205084,37857,3276,2355,5.6018170645,23781,4.3176357994,26525,8868,2625,21.63498759,26393,1.9698292898,9100,4054
2023-2024,8,06,Montréal,CIUSSS DE L'OUEST-DE-L'ÎLE-DE-MONTRÉAL,Total établissement,,63428,12081,7142,12.775399867,53787,2.7537413677,42112,4076,2699,6.2130913991,32552,3.3990085948,21316,8082,3066,25.739930464,21235,1.7645848442,8005,4443
2023-2024,8,06,Montréal,CIUSSS DU CENTRE-OUEST-DE-L'ÎLE-DE-MONTRÉAL,Total établissement,,55353,10748,3060,11.063148464,47199,2.6222795798,20006,1372,339,4.1787408916,12939,3.1814985273,35347,5698,1555,14.959644854,34260,2.4110789388,9376,2721
2023-2024,8,06,Montréal,CIUSSS DU CENTRE-SUD-DE-L'ÎLE-DE-MONTRÉAL,Total établissement,,49709,7961,5182,11.179217909,42411,2.2469455972,31032,2250,1888,4.90050029,23797,2.9715111732,18677,6601,1367,21.611362534,18614,1.3206273952,5711,3294
2023-2024,8,06,Montréal,CIUSSS DU NORD-DE-L'ÎLE-DE-MONTRÉAL,Total établissement,,86150,14118,6521,10.896085871,65522,3.3483967132,60576,4840,2673,6.1911384826,40023,4.4772000683,25574,9253,2539,22.04048616,25499,1.5766371666,9278,3848
2023-2024,8,06,Montréal,INSTITUT DE CARDIOLOGIE DE MONTRÉAL,Total établissement,,11985,3349,317,8.7093696287,11603,1.4766548881,7513,1499,262,3.934443668,7135,1.7348037842,4472,1003,64,16.731287952,4468,1.0644139809,1850,55
2023-2024,8,07,Outaouais,CISSS DE L'OUTAOUAIS,Total établissement,,95580,12977,5281,9.6626383309,71052,3.4485414008,70525,6113,2271,5.096410863,46633,3.4123098569,25055,7505,3324,22.515689306,24419,3.5177328333,6864,3010
2023-2024,8,08,Abitibi-Témiscamingue,CISSS DE L'ABITIBI-TÉMISCAMINGUE,Total établissement,,66765,7978,3538,6.143505858,56766,2.788562192,53830,4437,2495,4.8099061294,43976,3.0756284425,12935,1382,237,11.693383971,12790,1.801539093,3541,1043
2023-2024,8,09,Côte-Nord,CISSS DE LA CÔTE-NORD,Total établissement,,60587,7146,3304,6.1439175254,48472,2.6375604874,47732,4207,2132,3.8759914208,35906,2.7664923767,12855,2194,766,14.564971498,12566,2.2691514139,2939,1172
2023-2024,8,11,Gaspésie-Îles-de-la-Madeleine,CISSS DE LA GASPÉSIE,Total établissement,,50439,8765,2093,5.4917131254,44846,1.8787247655,40447,5290,1422,3.4246748969,35006,2.0191770062,9992,1760,423,13.858956443,9840,1.3790630646,3475,671
2023-2024,8,11,Gaspésie-Îles-de-la-Madeleine,CISSS DES ÎLES,Total établissement,,10420,1451,300,4.0762070004,9256,1.5449379682,8454,934,176,2.9402047026,7311,1.6274764434,1966,107,0,8.961132446,1945,1.234686661,517,124
2023-2024,8,12,Chaudière-Appalaches,CISSS DE CHAUDIÈRE-APPALACHES,Total établissement,,144020,23297,6133,5.7172436988,125249,1.7774519136,112174,11551,3217,3.3192576587,93442,2.0916386963,31846,5437,897,14.163883341,31807,0.8544399556,11746,2916
2023-2024,8,13,Laval,CISSS DE LAVAL,Total établissement,,56008,10781,3495,9.5397001321,43455,2.9925526471,35912,3374,845,5.4023343791,23405,3.8402116357,20096,4341,470,16.933264967,20050,2.0030534636,7407,2650
2023-2024,8,14,Lanaudière,CISSS DE LANAUDIÈRE,Total établissement,,89423,16067,5573,10.402449836,64377,4.0660193772,59053,5377,2963,6.2655006661,34186,5.120098749,30370,9080,1266,18.446547937,30191,2.872459793,10690,2610
2023-2024,8,15,Laurentides,CISSS DES LAURENTIDES,Total établissement,,117370,20774,8038,11.851958084,88656,4.0324490791,76566,7688,2524,6.5870413797,48216,5.052999016,40804,13486,4025,21.731225125,40440,2.8156628338,13086,5514
2023-2024,8,16,Montérégie,CISSS DE LA MONTÉRÉGIE-CENTRE,Total établissement,,84449,14968,5760,10.076260922,55026,4.3592043458,58283,5679,2097,5.8558391622,29021,5.1398207715,26166,7719,1880,19.476965708,26005,3.4880538251,9289,3663
2023-2024,8,16,Montérégie,CISSS DE LA MONTÉRÉGIE-EST,Total établissement,,86867,16932,4754,10.562825753,67257,3.9996923492,49501,6016,1667,5.6974355456,30351,4.6603715693,37366,8918,2360,17.008302408,36906,3.4563586093,10916,3087
2023-2024,8,16,Montérégie,CISSS DE LA MONTÉRÉGIE-OUEST,Total établissement,,61094,11422,3567,13.373416147,48474,2.7156193928,41839,4102,1608,6.7008083234,29263,3.5347181025,19255,7873,3582,27.872260019,19211,1.4679339239,7320,1959
2024-2025,8,01,Bas-Saint-Laurent,CISSS DU BAS-SAINT-LAURENT,Total établissement,,94004,16110,3751,4.7280892007,81189,2.0713425498,72564,8376,2277,3.3758060892,60072,2.2776450667,21440,1279,120,9.3049115749,21117,1.4844691875,7734,1474
2024-2025,8,02,Saguenay-Lac-Saint-Jean,CIUSSS DU SAGUENAY - LAC-SAINT-JEAN,Total établissement,,119725,19296,5699,6.3693536878,101826,2.9516912538,82744,8409,2163,4.1826356896,65487,3.3545928199,36981,3343,208,11.262076817,36339,2.2256169298,10887,3536
2024-2025,8,03,Capitale-Nationale,CHU DE QUÉBEC - UNIVERSITÉ LAVAL,Total établissement,,155607,27553,11940,8.9301946838,130432,2.1926432079,91146,8286,3876,4.5299430767,66410,2.9321961636,64461,12648,1891,15.152023898,64022,1.4255051649,19267,8064
2024-2025,8,03,Capitale-Nationale,CIUSSS DE LA CAPITALE-NATIONALE,Total établissement,,83185,10066,1636,3.8545315628,63208,1.9388380251,71121,6567,1087,3.0398389365,51321,2.1357190905,12064,678,105,8.6573958103,11887,1.0888226167,3499,549
2024-2025,8,03,Capitale-Nationale,INSTITUT UNIVERSITAIRE DE CARDIOLOGIE ET DE PNEUMOLOGIE DE QUÉBEC - UNIVERSITÉ LAVAL,Total établissement,,19442,6540,382,7.9196161089,18128,2.0586560385,10222,2339,199,4.0656055023,8936,2.6053056302,9220,981,0,12.192468215,9192,1.5272308046,4201,183
2024-2025,8,04,Mauricie et Centre-du-Québec,CIUSSS DE LA MAURICIE-ET-DU-CENTRE-DU-QUÉBEC,Total établissement,,161301,28898,8193,7.2818441144,126523,3.2099151384,105033,10272,2474,4.8790682452,71314,4.0283303029,56268,6212,408,11.767000116,55209,2.152760344,18626,5719
2024-2025,8,05,Estrie,CIUSSS DE L'ESTRIE - CENTRE HOSPITALIER UNIVERSITAIRE DE SHERBROOKE,Total établissement,,155937,25667,7868,8.784674117,126348,3.789660134,103044,9497,2891,5.9808822364,73853,4.8959953857,52893,9144,1306,14.246907882,52495,2.2332037601,16170,4977
2024-2025,8,06,Montréal,CENTRE HOSPITALIER DE L'UNIVERSITÉ DE MONTRÉAL,Total établissement,,49857,7396,4130,12.011826663,36090,3.137048336,29770,2130,1368,7.4846407271,16152,5.1320774173,20087,5982,627,18.721356474,19938,1.5208526432,5266,2762
2024-2025,8,06,Montréal,CENTRE HOSPITALIER UNIVERSITAIRE SAINTE-JUSTINE,Total établissement,,51387,1,1261,4.8943013851,44565,1.7107515053,33145,0,457,4.107431027,26728,2.2028973049,18242,243,6,6.3240140275,17837,0.9732915662,1,804
2024-2025,8,06,Montréal,CENTRE UNIVERSITAIRE DE SANTÉ MCGILL,Total établissement,,113120,10210,5420,11.495260377,96225,2.568112644,75706,2963,1504,6.0038092093,59207,3.0736090656,37414,10270,4875,22.607031429,37018,1.7596160577,7247,3916
2024-2025,8,06,Montréal,CIUSSS DE L'EST-DE-L'ÎLE-DE-MONTRÉAL,Total établissement,,72413,14121,6790,12.540004223,52829,3.4107249122,42867,3718,2522,5.4610087337,23528,4.8997136509,29546,10404,3415,22.81060937,29301,2.2151026795,10403,4268
2024-2025,8,06,Montréal,CIUSSS DE L'OUEST-DE-L'ÎLE-DE-MONTRÉAL,Total établissement,,70733,13760,7672,11.807967238,59202,3.0788652129,45800,4296,2863,6.4493559134,34374,3.9205341812,24933,7992,2134,21.65132338,24828,1.9135869337,9464,4809
2024-2025,8,06,Montréal,CIUSSS DU CENTRE-OUEST-DE-L'ÎLE-DE-MONTRÉAL,Total établissement,,61509,11649,3187,10.900573814,52761,2.5922478935,21425,1374,304,3.756429742,13711,2.9806787535,40084,6476,2034,14.719137,39050,2.4558643975,10275,2883
2024-2025,8,06,Montréal,CIUSSS DU CENTRE-SUD-DE-L'ÎLE-DE-MONTRÉAL,Total établissement,,53587,8689,5265,10.558371874,44873,2.3655535561,34421,2431,2049,5.3670395414,25770,3.1870543914,19166,5786,961,19.881697045,19103,1.25734665,6258,3216
2024-2025,8,06,Montréal,CIUSSS DU NORD-DE-L'ÎLE-DE-MONTRÉAL,Total établissement,,93857,15441,6931,10.611352702,69550,3.4772406143,65858,5147,2775,6.0554849997,41649,4.7205832206,27999,9951,2308,21.327461675,27901,1.6212506422,10294,4156
2024-2025,8,06,Montréal,INSTITUT DE CARDIOLOGIE DE MONTRÉAL,Total établissement,,12798,3467,307,7.2519033139,12365,1.5986729568,8504,1747,275,3.6007212946,8071,1.8442147469,4294,695,39,14.482842273,4294,1.1371527454,1720,32
2024-2025,8,07,Outaouais,CISSS DE L'OUTAOUAIS,Total établissement,,106616,15017,5954,9.3941063854,79478,4.1913953477,78620,6910,2470,5.5271062495,52460,4.0509137014,27996,7933,2360,20.253641701,27018,4.4641641375,8107,3484
2024-2025,8,08,Abitibi-Témiscamingue,CISSS DE L'ABITIBI-TÉMISCAMINGUE,Total établissement,,76204,9307,4078,6.2319589596,63833,3.1940981546,61975,5221,2957,5.0436956434,49772,3.5202175866,14229,1550,190,11.407489146,14061,2.0397267462,4086,1121
2024-2025,8,09,Côte-Nord,CISSS DE LA CÔTE-NORD,Total établissement,,66120,8000,3653,6.472780853,52891,3.2143764745,52374,4653,2180,4.6583120866,39492,3.421399735,13746,2068,577,13.386136533,13399,2.6041994013,3347,1473
2024-2025,8,11,Gaspésie-Îles-de-la-Madeleine,CISSS DE LA GASPÉSIE,Total établissement,,56367,9716,2235,5.0494963414,49449,2.0706254929,45386,6121,1469,3.594235086,38646,2.2387114018,10981,1187,165,11.064293477,10803,1.4693251103,3595,766
2024-2025,8,11,Gaspésie-Îles-de-la-Madeleine,CISSS DES ÎLES,Total établissement,,10594,1541,330,4.763346024,9132,1.9734108081,8581,1004,165,3.4068617359,7147,2.0885444942,2013,186,33,10.545756196,1985,1.5588715365,537,165
2024-2025,8,12,Chaudière-Appalaches,CISSS DE CHAUDIÈRE-APPALACHES,Total établissement,,156303,25619,6718,6.259219989,135100,2.0521798524,122067,13024,3447,3.6237668225,100926,2.4175799541,34236,6629,1705,15.655816019,34174,0.9730445254,12595,3271
2024-2025,8,13,Laval,CISSS DE LAVAL,Total établissement,,58946,11323,3903,10.652122286,45276,3.7998543747,37017,3515,826,6.5310918332,23453,4.889410535,21929,5461,502,17.608581052,21823,2.6289172611,7808,3077
2024-2025,8,14,Lanaudière,CISSS DE LANAUDIÈRE,Total établissement,,98397,17940,6230,10.028991706,72579,3.5273253972,64977,5884,3227,5.7885358665,39327,4.4290226887,33420,9871,1306,18.273518909,33252,2.4608918177,12056,3003
2024-2025,8,15,Laurentides,CISSS DES LAURENTIDES,Total établissement,,130139,23248,8555,11.705004728,99539,3.8265685477,84860,8536,2730,6.2717825634,54610,4.7797035036,45279,14539,4589,21.887721503,44929,2.6680584552,14712,5825
2024-2025,8,16,Montérégie,CISSS DE LA MONTÉRÉGIE-CENTRE,Total établissement,,87255,16126,6380,11.385985213,56245,5.0033722998,60334,6315,2242,6.5440764098,29399,6.0532846355,26921,9678,2564,22.237429279,26846,3.8536154362,9811,4138
2024-2025,8,16,Montérégie,CISSS DE LA MONTÉRÉGIE-EST,Total établissement,,91507,18471,5258,10.66797921,69115,4.5003172852,50677,6430,1776,5.8723960629,28725,5.3149539696,40830,9324,2181,16.62011654,40390,3.9209550975,12041,3482
2024-2025,8,16,Montérégie,CISSS DE LA MONTÉRÉGIE-OUEST,Total établissement,,63879,11362,4090,12.547020239,51297,2.4903946949,41032,3474,1703,5.9890101086,28886,3.4392008239,22847,7894,3546,24.32485854,22411,1.2674589115,7888,2387
2020-2021,8,01,Bas-Saint-Laurent,CISSS DU BAS-SAINT-LAURENT,CENTRE HOSPITALIER RÉGIONAL DU GRAND-PORTAGE,51218352,9651,1836,518,4.7356648419,8131,1.5169539417,6519,635,285,2.6602717271,5013,1.7511917902,3132,59,0,9.0554246488,3118,1.1403553738,1201,233
2020-2021,8,01,Bas-Saint-Laurent,CISSS DU BAS-SAINT-LAURENT,CENTRE MULTISERVICES DE SANTÉ ET DE SERVICES SOCIAUX DE TROIS-PISTOLES,51236156,4071,594,138,2.8407382161,3645,1.0574650968,3405,370,107,2.1907146353,2991,1.1618997734,666,10,0,6.1640569736,654,0.5798441216,224,31
2020-2021,8,01,Bas-Saint-Laurent,CISSS DU BAS-SAINT-LAURENT,CLSC DE POHÉNÉGAMOOK,51219418,3966,598,102,1.4128586037,3415,0.5387676102,3671,501,91,1.0356906989,3126,0.5472016955,295,0,0,6.1063615819,289,0.4475394079,97,11
2020-2021,8,01,Bas-Saint-Laurent,CISSS DU BAS-SAINT-LAURENT,HÔPITAL D'AMQUI,51226892,6919,1088,235,3.7412303078,6422,1.1145625714,4052,415,140,2.5731553691,3616,1.2266574484,2867,13,0,5.3920986901,2806,0.9701095866,673,95
2020-2021,8,01,Bas-Saint-Laurent,CISSS DU BAS-SAINT-LAURENT,HÔPITAL DE MATANE,51218980,9065,1678,446,4.0674825336,8059,1.7737947567,6681,809,242,3.2368115635,5721,2.0207635611,2384,39,0,6.3953821775,2338,1.1694711767,869,204
2020-2021,8,01,Bas-Saint-Laurent,CISSS DU BAS-SAINT-LAURENT,HÔPITAL DE NOTRE-DAME-DU-LAC,51221877,5920,987,195,3.3611951952,5448,0.8626312408,4451,491,94,1.7172098654,3986,0.9904693511,1469,33,0,8.342392406,1462,0.5140931373,496,101
2020-2021,8,01,Bas-Saint-Laurent,CISSS DU BAS-SAINT-LAURENT,HÔPITAL NOTRE-DAME-DE-FATIMA,51221141,7242,1267,208,3.6387322409,6702,1.0934625651,5556,632,101,2.2483589813,5024,1.1708843109,1686,8,0,8.220531666,1678,0.8616587207,635,107
2020-2021,8,01,Bas-Saint-Laurent,CISSS DU BAS-SAINT-LAURENT,HÔPITAL RÉGIONAL DE RIMOUSKI,51227882,16303,2948,1012,4.4820277965,13333,1.5662739902,11135,1118,650,3.0982513346,8193,1.8135359114,5168,34,0,7.4635198443,5140,1.1721461846,1830,362
2020-2021,8,02,Saguenay-Lac-Saint-Jean,CIUSSS DU SAGUENAY - LAC-SAINT-JEAN,HÔPITAL D'ALMA,51219400,15503,2320,665,4.117366585,12918,1.8443498521,11339,1167,257,2.7443298204,8819,1.9828111023,4164,101,11,7.8562868236,4099,1.5464504215,1153,408
2020-2021,8,02,Saguenay-Lac-Saint-Jean,CIUSSS DU SAGUENAY - LAC-SAINT-JEAN,HÔPITAL DE CHICOUTIMI,51218394,27674,4278,1743,6.2276794605,24977,1.3958210999,14338,1116,519,2.3955225818,11748,1.6320494269,13336,1118,54,10.347765343,13229,1.1860387742,3162,1224
2020-2021,8,02,Saguenay-Lac-Saint-Jean,CIUSSS DU SAGUENAY - LAC-SAINT-JEAN,HÔPITAL DE DOLBEAU-MISTASSINI,51219384,9244,1543,342,4.4408553897,8418,1.4439624086,7482,891,150,2.6751019113,6666,1.5503584108,1762,222,54,11.938793826,1752,1.0391474822,652,192
2020-2021,8,02,Saguenay-Lac-Saint-Jean,CIUSSS DU SAGUENAY - LAC-SAINT-JEAN,HÔPITAL DE LA BAIE,51221364,7961,1156,261,4.3981103016,7330,1.820247802,6067,536,143,2.9696828471,5451,2.0482755967,1894,44,1,8.9737541065,1879,1.1587366211,620,118
2020-2021,8,02,Saguenay-Lac-Saint-Jean,CIUSSS DU SAGUENAY - LAC-SAINT-JEAN,HÔPITAL ET CENTRE D'HÉBERGEMENT DE ROBERVAL,51228203,12522,1749,770,4.1312487356,11400,1.6444453216,8485,675,226,2.6621074445,7400,1.8286957583,4037,73,1,7.219102056,4000,1.3035820139,1074,544
2020-2021,8,02,Saguenay-Lac-Saint-Jean,CIUSSS DU SAGUENAY - LAC-SAINT-JEAN,HÔPITAL ET CENTRE DE RÉADAPTATION DE JONQUIÈRE,51224541,13803,2346,600,6.0302141644,11606,2.551771689,8758,812,246,3.8838712542,6642,2.8864414166,5045,141,3,9.7562144037,4964,2.103972267,1534,354
2020-2021,8,03,Capitale-Nationale,CHU DE QUÉBEC - UNIVERSITÉ LAVAL,CENTRE HOSPITALIER DE L'UNIVERSITÉ LAVAL,51217594,37902,3706,3869,7.6178072177,32906,1.5513352006,21238,709,1037,4.0808557905,16276,2.1717030529,16664,1917,448,12.125594929,16630,0.944173014,2997,2832
2020-2021,8,03,Capitale-Nationale,CHU DE QUÉBEC - UNIVERSITÉ LAVAL,HÔPITAL DE L'ENFANT-JÉSUS,51233914,33094,5149,4393,10.566546386,29973,1.3992397324,18304,1581,1036,3.6170005342,15195,1.8220502907,14790,3842,1221,19.167255465,14778,0.9644984662,3568,3357
2020-2021,8,03,Capitale-Nationale,CHU DE QUÉBEC - UNIVERSITÉ LAVAL,HÔPITAL DU SAINT-SACREMENT,51217529,16197,3402,534,7.5429408224,13785,1.544659352,11384,1268,221,3.0707119398,8983,1.8604318961,4813,1254,323,18.120928273,4802,0.9539503216,2134,313
2020-2021,8,03,Capitale-Nationale,CHU DE QUÉBEC - UNIVERSITÉ LAVAL,HÔPITAL SAINT-FRANÇOIS D'ASSISE,51217602,21742,4802,781,10.45739461,18484,1.732954928,12315,1272,314,4.0594627148,9081,2.3090715964,9427,2782,528,18.815359104,9403,1.1765670235,3530,467
2020-2021,8,03,Capitale-Nationale,CHU DE QUÉBEC - UNIVERSITÉ LAVAL,L'HÔTEL-DIEU DE QUÉBEC,51217586,9905,2327,528,8.223285518,8998,1.401642649,4615,554,195,3.351007283,3760,1.6134145981,5290,650,17,12.473864734,5238,1.2496261296,1773,333
2020-2021,8,03,Capitale-Nationale,CIUSSS DE LA CAPITALE-NATIONALE,CENTRE MULTISERVICES DE SANTÉ ET DE SERVICES SOCIAUX CHAUVEAU,51225001,15799,1059,272,2.4654990119,12462,1.2548401139,13867,888,221,2.2020008533,10551,1.3133974663,1932,0,0,4.3567665919,1911,0.9315336647,171,51
2020-2021,8,03,Capitale-Nationale,CIUSSS DE LA CAPITALE-NATIONALE,CENTRE MULTISERVICES DE SANTÉ ET DE SERVICES SOCIAUX DE BAIE-SAINT-PAUL,51244804,5720,1086,165,3.949904089,4463,1.3070556676,4368,605,69,2.3204838217,3120,1.4930665064,1352,55,3,9.2141849523,1343,0.8749232647,481,96
2020-2021,8,03,Capitale-Nationale,CIUSSS DE LA CAPITALE-NATIONALE,CENTRE MULTISERVICES DE SANTÉ ET DE SERVICES SOCIAUX DE SAINT-MARC-DES-CARRIÈRES,51247344,7153,1018,202,2.8706835127,6066,1.1749352951,5705,546,125,1.9939498004,4635,1.3394675177,1448,20,0,6.324941682,1431,0.6420164609,472,77
2020-2021,8,03,Capitale-Nationale,CIUSSS DE LA CAPITALE-NATIONALE,CENTRE MULTISERVICES DE SANTÉ ET DE SERVICES SOCIAUX DE SAINT-RAYMOND,51247302,9251,1282,220,3.7450157641,7775,1.7344963558,7207,600,134,2.7262984675,5759,1.9757880901,2044,49,0,7.3369411829,2016,1.0452110891,682,86
2020-2021,8,03,Capitale-Nationale,CIUSSS DE LA CAPITALE-NATIONALE,CENTRE MULTISERVICES DE SANTÉ ET DE SERVICES SOCIAUX DE SAINTE-ANNE-DE-BEAUPRÉ,51225357,7332,807,131,2.8400537219,5245,1.142064347,6411,499,101,2.1121275065,4334,1.211372353,921,31,2,7.9070840873,911,0.8123377851,308,30
2020-2021,8,03,Capitale-Nationale,CIUSSS DE LA CAPITALE-NATIONALE,HÔPITAL ET CLSC DE LA MALBAIE,51228690,6841,1047,256,4.7983183095,5688,1.212570177,5467,603,162,2.3934366299,4317,1.3888120608,1374,230,44,14.367086972,1371,0.6576203501,444,94
2020-2021,8,03,Capitale-Nationale,INSTITUT UNIVERSITAIRE DE CARDIOLOGIE ET DE PNEUMOLOGIE DE QUÉBEC - UNIVERSITÉ LAVAL,INSTITUT UNIVERSITAIRE DE CARDIOLOGIE ET DE PNEUMOLOGIE DE QUÉBEC,51232130,13776,4138,373,7.5235860071,13149,1.4717186985,6805,1292,211,3.6939644053,6185,1.905274634,6971,481,0,11.262013062,6964,1.0866607633,2846,162
2020-2021,8,04,Mauricie et Centre-du-Québec,CIUSSS DE LA MAURICIE-ET-DU-CENTRE-DU-QUÉBEC,CENTRE MULTISERVICES DE SANTÉ ET DE SERVICES SOCIAUX AVELLIN-DALCOURT,51233583,9906,1386,263,4.4742218521,8820,2.3208219955,8198,719,169,3.4127481974,7118,2.5754546377,1708,61,3,9.5690468059,1702,1.2559129782,667,94
2020-2021,8,04,Mauricie et Centre-du-Québec,CIUSSS DE LA MAURICIE-ET-DU-CENTRE-DU-QUÉBEC,CENTRE MULTISERVICES DE SANTÉ ET DE SERVICES SOCIAUX CHRIST-ROI,51246338,9088,1021,315,3.8939763363,7690,1.9671604537,7496,488,206,2.4749874007,6110,2.0804123477,1592,133,15,10.57534635,1580,1.5292053446,533,109
2020-2021,8,04,Mauricie et Centre-du-Québec,CIUSSS DE LA MAURICIE-ET-DU-CENTRE-DU-QUÉBEC,CENTRE MULTISERVICES DE SANTÉ ET DE SERVICES SOCIAUX DE FORTIERVILLE,51219160,5342,535,137,1.6012193727,4881,0.8152863143,4940,442,127,1.4803359762,4479,0.8450891196,402,0,0,3.0867019071,402,0.4832296849,93,10
2020-2021,8,04,Mauricie et Centre-du-Québec,CIUSSS DE LA MAURICIE-ET-DU-CENTRE-DU-QUÉBEC,CENTRE MULTISERVICES DE SANTÉ ET DE SERVICES SOCIAUX DU HAUT-SAINT-MAURICE,51219731,6235,954,319,4.0067346075,5256,1.8667078894,4706,503,166,2.7415713392,3744,2.0305021368,1529,42,0,7.9006903568,1512,1.461122134,451,153
2020-2021,8,04,Mauricie et Centre-du-Québec,CIUSSS DE LA MAURICIE-ET-DU-CENTRE-DU-QUÉBEC,HÔPITAL DU CENTRE-DE-LA-MAURICIE,51220051,17131,3205,1286,5.7404614117,14211,1.6901866903,9561,732,284,3.0505203431,6700,2.2149676617,7570,244,2,9.1378889623,7511,1.2220689285,2473,1002
2020-2021,8,04,Mauricie et Centre-du-Québec,CIUSSS DE LA MAURICIE-ET-DU-CENTRE-DU-QUÉBEC,HÔPITAL SAINTE-CROIX,51228781,21050,3034,1516,6.6458084587,17898,2.0686654934,12912,839,651,4.1557685357,9863,2.5473485361,8138,596,13,10.59658205,8035,1.4810798244,2195,865
2020-2021,8,04,Mauricie et Centre-du-Québec,CIUSSS DE LA MAURICIE-ET-DU-CENTRE-DU-QUÉBEC,HÔTEL-DIEU D'ARTHABASKA,51228039,17898,2924,1021,4.6419704716,14481,1.571089416,10169,855,235,2.6136383999,6861,1.9614554487,7729,134,0,7.3106350901,7620,1.2196062992,2069,786
2020-2021,8,04,Mauricie et Centre-du-Québec,CIUSSS DE LA MAURICIE-ET-DU-CENTRE-DU-QUÉBEC,PAVILLON SAINTE-MARIE,51220168,31012,6470,2262,8.9765597009,25109,2.2279420062,16546,1422,621,4.0679831144,10747,3.2139815504,14466,2643,152,14.590918072,14362,1.4900944236,5048,1641
2020-2021,8,05,Estrie,CIUSSS DE L'ESTRIE - CENTRE HOSPITALIER UNIVERSITAIRE DE SHERBROOKE,CENTRE DE SANTÉ ET DE SERVICES SOCIAUX DU GRANIT,51223832,7452,1024,288,6.3870267862,6433,3.0104308082,5782,507,170,4.7257982148,4771,3.2928372226,1670,207,10,12.138657685,1662,2.199744284,517,118
2020-2021,8,05,Estrie,CIUSSS DE L'ESTRIE - CENTRE HOSPITALIER UNIVERSITAIRE DE SHERBROOKE,CENTRE MULTISERVICES DE SANTÉ ET DE SERVICES SOCIAUX DE LA MRC DE COATICOOK,51247617,7177,560,251,2.9249469757,6370,1.6409545613,5363,291,174,2.2029735637,4591,1.715554285,1814,12,0,5.0594251501,1779,1.4484377928,269,77
2020-2021,8,05,Estrie,CIUSSS DE L'ESTRIE - CENTRE HOSPITALIER UNIVERSITAIRE DE SHERBROOKE,CENTRE MULTISERVICES DE SANTÉ ET DE SERVICES SOCIAUX DE MEMPHRÉMAGOG,51219046,11162,2169,438,6.250990837,9215,2.6829859227,7545,834,187,3.7881124365,5699,2.8700851514,3617,409,24,11.388512963,3516,2.3797212742,1335,251
2020-2021,8,05,Estrie,CIUSSS DE L'ESTRIE - CENTRE HOSPITALIER UNIVERSITAIRE DE SHERBROOKE,CENTRE MULTISERVICES DE SANTÉ ET DE SERVICES SOCIAUX DES SOURCES,51247583,7986,953,289,3.5801449411,6380,2.0371464646,6897,597,198,2.7718935769,5297,2.1654282823,1089,54,1,8.6990702479,1083,1.4097145275,356,91
2020-2021,8,05,Estrie,CIUSSS DE L'ESTRIE - CENTRE HOSPITALIER UNIVERSITAIRE DE SHERBROOKE,CHUS - HÔPITAL FLEURIMONT,51216687,22905,3306,498,7.2834635815,20856,1.7680147999,11664,604,216,4.7493627115,9617,2.7533880975,11241,792,32,9.9129229309,11239,0.9248494825,2702,282
2020-2021,8,05,Estrie,CIUSSS DE L'ESTRIE - CENTRE HOSPITALIER UNIVERSITAIRE DE SHERBROOKE,CHUS - HÔTEL-DIEU DE SHERBROOKE,51216695,25103,4552,3482,9.1263667025,22058,1.8179383141,11302,1007,694,4.0023417684,8275,2.538735146,13801,2081,482,13.32256479,13783,1.3851882754,3545,2788
2020-2021,8,05,Estrie,CIUSSS DE L'ESTRIE - CENTRE HOSPITALIER UNIVERSITAIRE DE SHERBROOKE,HÔPITAL BROME-MISSISQUOI-PERKINS,51229185,13939,2048,443,8.2629303473,12066,2.3791698897,9783,716,213,4.1767875396,7936,2.6805947581,4156,1039,327,17.881490282,4130,1.7999670433,1332,230
2020-2021,8,05,Estrie,CIUSSS DE L'ESTRIE - CENTRE HOSPITALIER UNIVERSITAIRE DE SHERBROOKE,HÔPITAL DE GRANBY,51228120,19763,3002,1390,8.4142632135,16650,2.2951999333,13220,1007,533,4.2887325601,10130,2.7851255073,6543,1612,252,16.749814985,6520,1.5340118865,1995,857
2020-2021,8,06,Montréal,CENTRE HOSPITALIER DE L'UNIVERSITÉ DE MONTRÉAL,CENTRE HOSPITALIER DE L'UNIVERSITÉ DE MONTRÉAL,51236297,32083,4579,2431,12.331034651,27985,2.1884901138,19053,1296,999,5.8164455,15018,2.9235622808,13030,4866,956,21.856933892,12967,1.3371510372,3283,1432
2020-2021,8,06,Montréal,CENTRE HOSPITALIER UNIVERSITAIRE SAINTE-JUSTINE,CHU SAINTE-JUSTINE,51222800,29115,0,838,4.2157942832,27871,1.084297966,19972,0,411,3.4393042343,18814,1.2282565288,9143,17,0,5.9119617619,9057,0.78525453,0,427
2020-2021,8,06,Montréal,CENTRE UNIVERSITAIRE DE SANTÉ MCGILL,HÔPITAL DE LACHINE,51228310,8382,1485,411,9.5699912511,7739,2.0593270377,4892,463,111,3.8656133597,4350,2.2066302682,3490,830,217,17.565927252,3389,1.8702538441,1022,300
2020-2021,8,06,Montréal,CENTRE UNIVERSITAIRE DE SANTÉ MCGILL,HÔPITAL GÉNÉRAL DE MONTRÉAL,51248219,15117,2591,1895,12.540893512,13926,1.2018017657,4077,293,243,4.3825773308,3018,1.7140869597,11040,2062,586,15.553706471,10908,1.060063893,2298,1652
2020-2021,8,06,Montréal,CENTRE UNIVERSITAIRE DE SANTÉ MCGILL,HÔPITAL ROYAL VICTORIA,51223295,23654,3630,702,13.018044928,20534,2.5513048413,14188,907,329,6.1063329731,11102,3.1359485028,9466,3344,1131,23.37758108,9432,1.8631460277,2723,373
2020-2021,8,06,Montréal,CENTRE UNIVERSITAIRE DE SANTÉ MCGILL,L'HÔPITAL DE MONTRÉAL POUR ENFANTS,51223279,23998,3,921,4.6539893371,23598,0.9706786592,16249,0,331,3.6204752771,15868,1.0863617903,7749,103,4,6.8211812277,7730,0.7332064827,3,590
2020-2021,8,06,Montréal,CIUSSS DE L'EST-DE-L'ÎLE-DE-MONTRÉAL,HÔPITAL MAISONNEUVE-ROSEMONT,12934659,33774,6501,2925,12.98598474,28001,2.5811413878,18366,1429,737,5.0598734981,12706,3.5362680798,15408,5558,1563,22.433736497,15295,1.7876899495,5072,2188
2020-2021,8,06,Montréal,CIUSSS DE L'EST-DE-L'ÎLE-DE-MONTRÉAL,HÔPITAL SANTA CABRINI,51235919,18773,4534,916,13.61069784,16752,2.6989570068,11184,1139,356,5.1568203833,9183,3.5763063088,7589,3187,1266,26.069278085,7569,1.6345233115,3395,560
2020-2021,8,06,Montréal,CIUSSS DE L'EST-DE-L'ÎLE-DE-MONTRÉAL,INSTITUT UNIVERSITAIRE EN SANTÉ MENTALE DE MONTRÉAL,51235307,2459,117,2447,14.508813429,2370,1.2267686357,1152,32,1146,3.6562065972,1063,1.4272747465,1307,522,198,24.074385786,1307,1.0636944232,85,1301
2020-2021,8,06,Montréal,CIUSSS DE L'OUEST-DE-L'ÎLE-DE-MONTRÉAL,CENTRE HOSPITALIER DE ST. MARY,51248243,18576,3305,1560,8.402760641,18012,1.4705046636,12220,1054,538,4.1069120522,11664,1.6520740693,6356,1419,137,16.661928318,6348,1.1368837517,2251,1022
2020-2021,8,06,Montréal,CIUSSS DE L'OUEST-DE-L'ÎLE-DE-MONTRÉAL,HÔPITAL DE LASALLE,51224392,13875,1752,497,8.1441063063,12477,2.7271157819,10195,576,190,5.100590431,8814,3.1341284699,3680,982,49,16.57580314,3663,1.7477519186,1176,307
2020-2021,8,06,Montréal,CIUSSS DE L'OUEST-DE-L'ÎLE-DE-MONTRÉAL,HÔPITAL DOUGLAS,51235190,3224,91,3096,12.27200467,2953,2.6043406893,1288,31,1177,3.8119522084,1020,2.3236928105,1936,486,66,17.900386679,1933,2.7524321722,60,1919
2020-2021,8,06,Montréal,CIUSSS DE L'OUEST-DE-L'ÎLE-DE-MONTRÉAL,HÔPITAL GÉNÉRAL DU LAKESHORE,51228278,19786,3915,1157,12.542426814,18638,1.8165738157,11496,923,187,5.4961794682,10378,2.248766354,8290,2855,900,22.313676451,8260,1.2735599946,2992,970
2020-2021,8,06,Montréal,CIUSSS DU CENTRE-OUEST-DE-L'ÎLE-DE-MONTRÉAL,HÔPITAL GÉNÉRAL JUIF,51248250,38652,7201,2112,8.1398282323,36495,1.1804388272,15244,841,248,3.2616554236,13305,1.3154567205,23408,2402,363,11.316642411,23190,1.1029738393,6360,1864
2020-2021,8,06,Montréal,CIUSSS DU CENTRE-SUD-DE-L'ÎLE-DE-MONTRÉAL,HÔPITAL DE VERDUN,51218097,20019,2874,1625,9.7707053299,18108,1.3358239452,11586,785,474,3.4659391363,9983,1.7105260888,8433,2674,637,18.432749812,8125,0.8754360684,2089,1151
2020-2021,8,06,Montréal,CIUSSS DU CENTRE-SUD-DE-L'ÎLE-DE-MONTRÉAL,HÔPITAL NOTRE-DAME,51236313,19305,2413,3009,12.387460071,17094,2.0026105651,10904,560,1076,4.8280265397,8881,2.5992476135,8401,2940,978,22.199156681,8213,1.3574463588,1853,1933
2020-2021,8,06,Montréal,CIUSSS DU NORD-DE-L'ÎLE-DE-MONTRÉAL,HÔPITAL DU SACRÉ-COEUR-DE-MONTRÉAL,12475976,28193,5065,1532,10.931474716,25580,1.6788122882,17663,1411,711,4.7028053621,15071,2.2469183826,10530,3360,1181,21.379431677,10509,0.8640890084,3654,821
2020-2021,8,06,Montréal,CIUSSS DU NORD-DE-L'ÎLE-DE-MONTRÉAL,HÔPITAL EN SANTÉ MENTALE ALBERT-PRÉVOST,51848752,1872,72,1869,16.086956167,1852,0.3247777178,726,22,723,3.2937117386,706,0.4851994806,1146,469,119,24.191576983,1146,0.2259489529,50,1146
2020-2021,8,06,Montréal,CIUSSS DU NORD-DE-L'ÎLE-DE-MONTRÉAL,HÔPITAL FLEURY,51228492,16198,2391,861,7.8244908494,13558,2.3874684483,12057,918,441,4.1978304443,9434,2.77944521,4141,1205,108,18.383931686,4124,1.4907883393,1473,420
2020-2021,8,06,Montréal,CIUSSS DU NORD-DE-L'ÎLE-DE-MONTRÉAL,HÔPITAL JEAN-TALON,51228500,19204,2353,1638,7.8418100106,16349,2.3014378215,13778,667,722,4.6936775213,10937,2.8730554032,5426,1183,101,15.83572255,5412,1.1462675536,1686,916
2020-2021,8,06,Montréal,INSTITUT DE CARDIOLOGIE DE MONTRÉAL,INSTITUT DE CARDIOLOGIE DE MONTRÉAL,51248201,9828,2603,346,8.4883215755,9612,1.1171685856,6171,1173,299,3.1135543042,5957,1.2380328465,3657,985,107,17.557965773,3655,0.9201813345,1430,47
2020-2021,8,07,Outaouais,CISSS DE L'OUTAOUAIS,CENTRE MULTISERVICES DE SANTÉ ET DE SERVICES SOCIAUX DE MANSFIELD-ET-PONTEFRACT,51245058,4687,523,163,3.9555776616,3738,1.6541995125,4506,485,160,3.7593418652,3557,1.6643975104,181,8,1,8.8408732351,181,1.4537891344,38,3
2020-2021,8,07,Outaouais,CISSS DE L'OUTAOUAIS,CLSC ET CENTRE D'HÉBERGEMENT DE LA PETITE-NATION,51219491,4787,642,179,2.4700036557,4001,0.8691786081,4296,510,158,2.2539302064,3512,0.9120283631,491,2,0,4.3605363204,489,0.5614314928,132,21
2020-2021,8,07,Outaouais,CISSS DE L'OUTAOUAIS,HÔPITAL DE GATINEAU,51221703,19315,2563,2438,9.9193175856,13966,2.5935355108,11388,820,678,3.6964102076,6151,2.7260040373,7927,2037,661,18.85920269,7815,2.489272695,1743,1760
2020-2021,8,07,Outaouais,CISSS DE L'OUTAOUAIS,HÔPITAL DE HULL,51221711,17149,3091,725,10.210986274,12624,2.4549208078,10104,793,428,3.9560619557,5671,2.7841226317,7045,1912,637,19.18185289,6953,2.1864174936,2298,297
2020-2021,8,07,Outaouais,CISSS DE L'OUTAOUAIS,HÔPITAL DE MANIWAKI,51221893,7766,941,391,4.9313564469,6299,2.1358989522,5499,428,193,3.1793591764,4106,2.3085751881,2267,140,49,9.181128388,2193,1.8125936059,513,198
2020-2021,8,07,Outaouais,CISSS DE L'OUTAOUAIS,HÔPITAL ET CHSLD DE PAPINEAU,51228823,11183,1348,531,7.1576548978,8741,2.9744841043,7958,458,190,3.7803377454,5579,3.0068436199,3225,597,92,15.491512231,3162,2.9173893106,890,341
2020-2021,8,07,Outaouais,CISSS DE L'OUTAOUAIS,HÔPITAL ET CHSLD DU PONTIAC,51219459,5243,666,159,4.738948916,4783,1.7553807466,4586,520,116,4.0391197849,4130,1.7929546677,657,29,0,9.623905378,653,1.5177386422,146,43
2020-2021,8,07,Outaouais,CISSS DE L'OUTAOUAIS,HÔPITAL ET CHSLD MÉMORIAL DE WAKEFIELD / WAKEFIELD MEMORIAL HOSPITAL,51228799,7091,632,211,5.1363176327,5981,2.1455649371,5964,411,164,3.6725432223,4866,2.279003231,1127,177,37,12.882502711,1115,1.5632234679,221,47
2020-2021,8,08,Abitibi-Témiscamingue,CISSS DE L'ABITIBI-TÉMISCAMINGUE,CENTRE MULTISERVICES DE SANTÉ ET DE SERVICES SOCIAUX DE LA SARRE,51247559,8515,1085,458,3.7792437855,8000,1.1876795833,7221,681,403,3.1538687316,6710,1.2339418778,1294,35,0,7.2690685643,1290,0.9470439276,404,55
2020-2021,8,08,Abitibi-Témiscamingue,CISSS DE L'ABITIBI-TÉMISCAMINGUE,CENTRE MULTISERVICES DE SANTÉ ET DE SERVICES SOCIAUX DE TÉMISCAMING-KIPAWA,51247476,2415,224,129,2.4699503106,2235,0.7075162814,2394,216,127,2.3836202775,2214,0.7073224681,21,3,0,12.311574074,21,0.7279497354,8,2
2020-2021,8,08,Abitibi-Témiscamingue,CISSS DE L'ABITIBI-TÉMISCAMINGUE,CENTRE MULTISERVICES DE SANTÉ ET DE SERVICES SOCIAUX DE VILLE-MARIE,51247542,6049,852,348,4.0041142246,5455,1.8228761075,5335,637,277,3.3670136936,4745,1.8836845217,714,17,0,8.7645222533,710,1.4164874804,215,71
2020-2021,8,08,Abitibi-Témiscamingue,CISSS DE L'ABITIBI-TÉMISCAMINGUE,HÔPITAL D'AMOS,51228906,9204,982,428,3.9375997755,7990,0.7287966555,6660,366,338,1.7667551718,5449,0.8331839175,2544,214,29,9.6207071104,2541,0.5049453409,616,90
2020-2021,8,08,Abitibi-Témiscamingue,CISSS DE L'ABITIBI-TÉMISCAMINGUE,HÔPITAL DE ROUYN-NORANDA,51228922,12789,1697,769,5.3735593305,10496,2.4527669271,10017,836,482,4.1912097213,7737,2.757438499,2772,168,4,9.646140873,2759,1.5983834723,861,287
2020-2021,8,08,Abitibi-Témiscamingue,CISSS DE L'ABITIBI-TÉMISCAMINGUE,HÔPITAL DE VAL-D'OR,51225589,14978,1627,1169,6.249873036,12457,2.8715710935,11853,840,828,4.1930482203,9343,3.2921246744,3125,550,77,14.051327289,3114,1.6097752979,787,341
2020-2021,8,09,Côte-Nord,CISSS DE LA CÔTE-NORD,CENTRE MULTISERVICES DE SANTÉ ET DE SERVICES SOCIAUX DE FERMONT,51245108,2267,5,128,5.4447448905,1933,1.5178012014,2174,5,121,5.4714923847,1840,1.5322924215,93,0,0,4.8194862605,93,1.23109319,0,7
2020-2021,8,09,Côte-Nord,CISSS DE LA CÔTE-NORD,CENTRE MULTISERVICES DE SANTÉ ET DE SERVICES SOCIAUX DE FORESTVILLE,51218741,5334,716,195,2.6064420072,4256,1.2079890481,4517,505,152,1.9565244262,3561,1.282429639,817,25,2,6.1996827825,695,0.8265747402,211,43
2020-2021,8,09,Côte-Nord,CISSS DE LA CÔTE-NORD,CENTRE MULTISERVICES DE SANTÉ ET DE SERVICES SOCIAUX DE LA BASSE-CÔTE-NORD,51245140,1741,248,74,3.4175844023,1705,1.1884410231,1485,171,65,3.2097572016,1452,1.2102219161,256,1,0,4.6231445313,253,1.0634376372,77,9
2020-2021,8,09,Côte-Nord,CISSS DE LA CÔTE-NORD,CENTRE MULTISERVICES DE SANTÉ ET DE SERVICES SOCIAUX DE LA MINGANIE,51245116,5740,457,184,2.4979883372,2280,1.6693044591,4320,310,96,1.832221322,1253,1.8474600958,1420,1,1,4.5234203834,1027,1.451944174,147,88
2020-2021,8,09,Côte-Nord,CISSS DE LA CÔTE-NORD,CENTRE MULTISERVICES DE SANTÉ ET DE SERVICES SOCIAUX DE PORT-CARTIER,51245132,5839,450,244,3.7284283363,5339,1.2617936151,5238,297,202,2.3054125833,4740,1.3299803094,601,94,27,16.130685432,599,0.7222194398,153,42
2020-2021,8,09,Côte-Nord,CISSS DE LA CÔTE-NORD,CENTRE MULTISERVICES DE SANTÉ ET DE SERVICES SOCIAUX DES ESCOUMINS,51218733,4644,775,151,2.7746783783,4290,0.9361926962,4032,515,130,2.1669526427,3680,0.9683731129,612,6,0,6.7785185185,610,0.7420551002,260,21
2020-2021,8,09,Côte-Nord,CISSS DE LA CÔTE-NORD,CLSC ET HÔPITAL LE ROYER,51228765,10720,1560,799,10.072803612,9791,2.6099000499,7637,602,471,4.5921941789,6712,2.9904747302,3083,937,520,23.649000252,3079,1.7802744398,958,328
2020-2021,8,09,Côte-Nord,CISSS DE LA CÔTE-NORD,HÔPITAL ET CLSC DE SEPT-ÎLES,51232023,10635,1215,800,8.0528197775,8567,2.5368591365,6938,462,307,3.6149822235,4953,2.7119905445,3697,699,270,16.381117573,3614,2.2968409119,753,493
2020-2021,8,11,Gaspésie-Îles-de-la-Madeleine,CISSS DE LA GASPÉSIE,CENTRE MULTISERVICES DE SANTÉ ET DE SERVICES SOCIAUX DE GRANDE-VALLÉE,51247732,2761,515,56,1.6759400781,2141,0.7566404588,2461,411,49,1.2811982482,1877,0.7808192743,300,3,0,4.9141388889,264,0.5847327441,104,7
2020-2021,8,11,Gaspésie-Îles-de-la-Madeleine,CISSS DE LA GASPÉSIE,CLSC ET CENTRE DE SERVICES AMBULATOIRES DE MURDOCHVILLE,51221307,871,104,55,2.775343156,828,1.8637473162,866,102,55,2.7622347318,823,1.8695673012,5,0,0,5.0457222222,5,0.9057777778,2,0
2020-2021,8,11,Gaspésie-Îles-de-la-Madeleine,CISSS DE LA GASPÉSIE,CLSC ET CENTRE DE SERVICES AMBULATOIRES DE PASPÉBIAC,51220978,5747,1074,236,3.3645168494,5313,1.3039471318,4163,650,190,2.5127195265,3851,1.3917136242,1584,39,7,5.603173576,1462,1.0727646679,424,46
2020-2021,8,11,Gaspésie-Îles-de-la-Madeleine,CISSS DE LA GASPÉSIE,HÔPITAL DE CHANDLER,51227775,7391,1220,291,4.5793536057,6612,1.3426546851,5985,685,219,2.9064147406,5212,1.4664491132,1406,129,12,11.700647424,1400,0.8817857143,535,72
2020-2021,8,11,Gaspésie-Îles-de-la-Madeleine,CISSS DE LA GASPÉSIE,HÔPITAL DE GASPÉ,51220903,6655,1079,321,3.8119954086,6156,0.9144976897,5227,594,252,2.5814504283,4732,1.0107716376,1428,33,0,8.3162381341,1424,0.5945761158,485,69
2020-2021,8,11,Gaspésie-Îles-de-la-Madeleine,CISSS DE LA GASPÉSIE,HÔPITAL ET CLSC DE SAINTE-ANNE-DES-MONTS,51247799,6871,1032,320,4.0673981225,6277,0.9867570761,5359,546,198,1.9192198482,4775,1.0428756835,1512,175,70,11.681212522,1502,0.8083507176,486,122
2020-2021,8,11,Gaspésie-Îles-de-la-Madeleine,CISSS DE LA GASPÉSIE,HÔPITAL ET GROUPE DE MÉDECINE DE FAMILLE UNIVERSITAIRE DE MARIA,51227908,7647,1373,377,8.4302284847,7036,1.840314928,5196,496,160,3.9941644213,4598,2.0701217317,2451,659,204,17.834467111,2438,1.406905706,877,217
2020-2021,8,11,Gaspésie-Îles-de-la-Madeleine,CISSS DES ÎLES,HÔPITAL DE L'ARCHIPEL,51227783,6763,769,177,3.423148422,5803,0.7658509487,5490,455,94,1.7614848209,4541,0.8074013923,1273,105,9,10.589317448,1262,0.6163417855,314,83
2020-2021,8,12,Chaudière-Appalaches,CISSS DE CHAUDIÈRE-APPALACHES,CHSLD ET HÔPITAL PAUL-GILBERT,51245199,28,1,1,0.8799702381,17,0.3811601307,28,1,1,0.8799702381,17,0.3811601307,0,0,0,,0,,0,0
2020-2021,8,12,Chaudière-Appalaches,CISSS DE CHAUDIÈRE-APPALACHES,HÔPITAL DE MONTMAGNY,51245223,15059,2413,567,4.0803482598,14004,0.9039787243,10965,1049,287,1.9278886356,9912,1.0551224946,4094,162,0,9.8453017967,4092,0.5378650755,1364,280
2020-2021,8,12,Chaudière-Appalaches,CISSS DE CHAUDIÈRE-APPALACHES,HÔPITAL DE SAINT-GEORGES,51228971,19997,3363,1027,5.5949516039,17233,1.3735566291,13253,1129,404,2.7747960629,10504,1.6412498942,6744,495,7,11.136992141,6729,0.9556862089,2234,623
2020-2021,8,12,Chaudière-Appalaches,CISSS DE CHAUDIÈRE-APPALACHES,HÔPITAL DE THETFORD,51245231,16970,2876,560,4.8386254665,14271,0.7986694851,12577,1322,251,2.5646771002,9879,0.8845451631,4393,368,11,11.348857336,4392,0.6055078678,1554,309
2020-2021,8,12,Chaudière-Appalaches,CISSS DE CHAUDIÈRE-APPALACHES,HÔTEL-DIEU DE LÉVIS,51227569,39560,6837,2430,6.2396100719,33913,0.7045391721,26535,2176,1151,2.3273552017,20892,0.8785927229,13025,2248,184,14.209796865,13021,0.4252728498,4661,1279
2020-2021,8,13,Laval,CISSS DE LAVAL,HÔPITAL DE LA CITÉ-DE-LA-SANTÉ,51228757,44381,7778,3149,8.366527493,35485,2.2177562272,28186,2144,939,4.3044467111,19330,2.8228412657,16195,3019,207,15.436228568,16155,1.4937516593,5634,2210
2020-2021,8,14,Lanaudière,CISSS DE LANAUDIÈRE,HÔPITAL DE LANAUDIÈRE ET CENTRE D'HÉBERGEMENT PARPHILIA-FERLAND,51244945,31795,4987,2426,8.5565476752,29004,1.5661974019,18766,1152,1567,4.3226230802,16053,1.9244468151,13029,2553,200,14.654776929,12951,1.1221407399,3835,859
2020-2021,8,14,Lanaudière,CISSS DE LANAUDIÈRE,HÔPITAL PIERRE-LE GARDEUR,51228062,38453,5888,2399,9.3018390705,28040,3.2774297135,24351,1865,746,4.9884934796,14084,4.2984320861,14102,3432,363,16.750022199,13956,2.2470630314,4023,1653
2020-2021,8,15,Laurentides,CISSS DES LAURENTIDES,CENTRE MULTISERVICES DE SANTÉ ET DE SERVICES SOCIAUX D'ARGENTEUIL,51245306,9402,1105,465,7.1418751625,8318,2.5964210481,7695,609,288,4.418416432,6614,2.8398533414,1707,492,95,19.418978227,1704,1.6515494588,496,177
2020-2021,8,15,Laurentides,CISSS DES LAURENTIDES,CENTRE MULTISERVICES DE SANTÉ ET DE SERVICES SOCIAUX DE RIVIÈRE-ROUGE,51217628,7020,824,402,5.2549198322,6468,1.8159107658,4987,374,154,2.8556127041,4467,1.9336676989,2033,228,49,11.140480407,2001,1.5530320951,450,248
2020-2021,8,15,Laurentides,CISSS DES LAURENTIDES,CENTRE MULTISERVICES DE SANTÉ ET DE SERVICES SOCIAUX DE SAINTE-AGATHE,51246874,16089,2400,1013,9.873802529,13320,3.8471270854,10491,896,283,6.2417647401,7783,4.8245547275,5598,1108,191,16.680467131,5537,2.4732207573,1504,730
2020-2021,8,15,Laurentides,CISSS DES LAURENTIDES,HÔPITAL DE MONT-LAURIER,51217610,8996,1135,490,6.6336820377,7981,2.3355346726,6795,562,272,4.1463430627,5804,2.4980138219,2201,360,82,14.312677192,2177,1.9023564538,573,218
2020-2021,8,15,Laurentides,CISSS DES LAURENTIDES,HÔPITAL DE SAINT-EUSTACHE,51228864,24810,4338,1636,10.699485758,20245,2.3480489696,13534,986,546,4.945080189,8992,3.4171010034,11276,2896,573,17.606201347,11253,1.4937953583,3352,1090
2020-2021,8,15,Laurentides,CISSS DES LAURENTIDES,HÔPITAL DE SAINT-JÉRÔME,51228880,27613,4364,2904,14.000303792,21474,3.0306313837,15128,1250,892,5.7664545692,9072,4.2211565501,12485,4099,1787,23.977209763,12402,2.1597682721,3114,2012
2020-2021,8,16,Montérégie,CISSS DE LA MONTÉRÉGIE-CENTRE,HÔPITAL CHARLES-LE MOYNE,51233799,36814,6866,3411,9.626846648,26314,2.7108605685,23555,2149,1408,4.2834470153,13066,3.2428834804,13259,3875,606,19.119551856,13248,2.1861465462,4717,2003
2020-2021,8,16,Montérégie,CISSS DE LA MONTÉRÉGIE-CENTRE,HÔPITAL DU HAUT-RICHELIEU,51229045,32188,4824,2340,8.923445159,27065,1.9593645442,21116,1409,732,3.8863388215,16035,2.4333897204,11072,3098,804,18.529978524,11030,1.2702445351,3415,1608
2020-2021,8,16,Montérégie,CISSS DE LA MONTÉRÉGIE-EST,HÔPITAL HONORÉ-MERCIER,51229193,24365,4128,1660,8.2358913628,19814,2.1853345839,17777,1669,866,3.9038664973,13233,2.5961507217,6588,2228,397,19.925388332,6581,1.3592701633,2459,794
2020-2021,8,16,Montérégie,CISSS DE LA MONTÉRÉGIE-EST,HÔPITAL PIERRE-BOUCHER,51229011,29178,5355,1905,11.02609943,23511,2.4085344803,15226,1555,594,4.1289024986,9634,2.8723216963,13952,3780,1185,18.553100611,13877,2.08655379,3800,1311
2020-2021,8,16,Montérégie,CISSS DE LA MONTÉRÉGIE-EST,HÔTEL-DIEU DE SOREL,51229102,17479,2910,954,7.188363576,15541,1.6369014042,10606,1008,256,3.8317071574,8695,2.1380651396,6873,1002,112,12.368153766,6846,1.0003810011,1902,698
2020-2021,8,16,Montérégie,CISSS DE LA MONTÉRÉGIE-OUEST,HÔPITAL ANNA-LABERGE,51229151,22460,3916,1404,11.258632383,18850,2.3537466991,14270,1071,410,5.4555349217,10664,3.0233519317,8190,2772,696,21.36976801,8186,1.4814439626,2845,994
2020-2021,8,16,Montérégie,CISSS DE LA MONTÉRÉGIE-OUEST,HÔPITAL BARRIE MEMORIAL / BARRIE MEMORIAL HOSPITAL,51228005,9159,897,223,5.162567784,8092,2.1532508101,7628,491,180,3.2310338737,6566,1.8225839341,1531,304,32,14.786173706,1526,3.5760284695,406,43
2020-2021,8,16,Montérégie,CISSS DE LA MONTÉRÉGIE-OUEST,HÔPITAL DU SUROÎT,51229136,19845,3913,1588,13.461728003,17609,1.8320147052,12056,979,1041,4.210285266,9854,2.4395203865,7789,2766,1518,27.781331757,7755,1.0600790529,2934,547
2021-2022,8,01,Bas-Saint-Laurent,CISSS DU BAS-SAINT-LAURENT,CENTRE HOSPITALIER RÉGIONAL DU GRAND-PORTAGE,51218352,12118,2040,595,5.0636317416,10160,2.1620298556,8680,832,375,3.2219578213,6738,2.4475034629,3438,73,0,9.7133494926,3422,1.5999254822,1208,220
2021-2022,8,01,Bas-Saint-Laurent,CISSS DU BAS-SAINT-LAURENT,CENTRE MULTISERVICES DE SANTÉ ET DE SERVICES SOCIAUX DE TROIS-PISTOLES,51236156,5827,883,181,3.3598295769,5281,1.4762152055,5111,603,159,2.7068071589,4575,1.5803811779,716,31,2,8.0212787089,706,0.8012019987,280,22
2021-2022,8,01,Bas-Saint-Laurent,CISSS DU BAS-SAINT-LAURENT,CLSC DE POHÉNÉGAMOOK,51219418,5260,639,155,1.4782940431,4709,0.6544966494,4957,556,145,1.2101205927,4410,0.6658626228,303,3,0,5.8655408874,299,0.4868580453,83,10
2021-2022,8,01,Bas-Saint-Laurent,CISSS DU BAS-SAINT-LAURENT,HÔPITAL D'AMQUI,51226892,9101,1365,312,3.7716289114,8152,1.5916570576,5292,515,177,3.0048826321,4474,1.8219230244,3809,16,1,4.8369009801,3678,1.311556477,850,135
2021-2022,8,01,Bas-Saint-Laurent,CISSS DU BAS-SAINT-LAURENT,HÔPITAL DE MATANE,51218980,10693,1696,509,4.4655970417,9424,2.3500736889,8312,918,305,3.9052964255,7080,2.6556305712,2381,40,0,6.4215897849,2344,1.4271459044,778,204
2021-2022,8,01,Bas-Saint-Laurent,CISSS DU BAS-SAINT-LAURENT,HÔPITAL DE NOTRE-DAME-DU-LAC,51221877,7958,1256,228,3.5294448982,7055,1.2766750532,6234,698,118,2.2478200192,5347,1.4549124119,1724,39,0,8.163812355,1708,0.7186919399,558,110
2021-2022,8,01,Bas-Saint-Laurent,CISSS DU BAS-SAINT-LAURENT,HÔPITAL NOTRE-DAME-DE-FATIMA,51221141,8895,1410,315,3.4693875148,8307,1.3697451948,7243,765,193,2.5947019728,6667,1.4633547906,1652,2,0,7.3043435566,1640,0.9891993564,645,122
2021-2022,8,01,Bas-Saint-Laurent,CISSS DU BAS-SAINT-LAURENT,HÔPITAL RÉGIONAL DE RIMOUSKI,51227882,20071,3325,1167,4.9348217439,16345,2.0656835934,14566,1460,707,3.6666686881,10871,2.442215272,5505,140,2,8.2903017459,5474,1.3179167174,1865,460
2021-2022,8,02,Saguenay-Lac-Saint-Jean,CIUSSS DU SAGUENAY - LAC-SAINT-JEAN,HÔPITAL D'ALMA,51219400,19690,2775,733,4.5823006884,15386,2.2727844938,15031,1481,327,3.1642825938,10825,2.4293555299,4659,230,24,9.1571515108,4561,1.9011814539,1294,406
2021-2022,8,02,Saguenay-Lac-Saint-Jean,CIUSSS DU SAGUENAY - LAC-SAINT-JEAN,HÔPITAL DE CHICOUTIMI,51218394,32470,4874,2003,7.1088381155,28118,2.1288084541,18509,1440,598,3.3655254051,14307,2.7406493907,13961,1818,178,12.071589706,13811,1.4949942276,3434,1405
2021-2022,8,02,Saguenay-Lac-Saint-Jean,CIUSSS DU SAGUENAY - LAC-SAINT-JEAN,HÔPITAL DE DOLBEAU-MISTASSINI,51219384,11397,1707,466,4.225589702,10429,1.8150663215,9384,1034,224,3.0568470565,8433,1.9538710687,2013,157,28,9.6739160733,1996,1.2286232187,673,242
2021-2022,8,02,Saguenay-Lac-Saint-Jean,CIUSSS DU SAGUENAY - LAC-SAINT-JEAN,HÔPITAL DE LA BAIE,51221364,9972,1307,327,4.9477544068,8944,2.363917058,7916,672,210,3.5391903529,6917,2.6009969801,2056,139,13,10.371000054,2027,1.554897906,635,117
2021-2022,8,02,Saguenay-Lac-Saint-Jean,CIUSSS DU SAGUENAY - LAC-SAINT-JEAN,HÔPITAL ET CENTRE D'HÉBERGEMENT DE ROBERVAL,51228203,14077,1911,933,5.6308840267,12665,2.2839624951,9579,725,278,3.4501718168,8250,2.475559899,4498,379,71,10.27495745,4415,1.9259379011,1186,655
2021-2022,8,02,Saguenay-Lac-Saint-Jean,CIUSSS DU SAGUENAY - LAC-SAINT-JEAN,HÔPITAL ET CENTRE DE RÉADAPTATION DE JONQUIÈRE,51224541,15774,2594,701,6.8802247017,12846,3.4329602816,10189,920,266,4.4976602218,7402,3.8080546924,5585,385,17,11.22685845,5444,2.9229586599,1674,435
2021-2022,8,03,Capitale-Nationale,CHU DE QUÉBEC - UNIVERSITÉ LAVAL,CENTRE HOSPITALIER DE L'UNIVERSITÉ LAVAL,51217594,47899,3611,4334,7.4455673802,38721,1.8093331856,28393,759,1332,4.4593266337,19273,2.638805655,19506,2060,432,11.792349576,19448,0.9873246035,2852,3002
2021-2022,8,03,Capitale-Nationale,CHU DE QUÉBEC - UNIVERSITÉ LAVAL,HÔPITAL DE L'ENFANT-JÉSUS,51233914,37220,5683,4436,9.6060889456,33071,1.6467735663,21189,1825,965,4.0857026838,17050,2.2119460736,16031,3647,795,16.902668354,16021,1.0453010458,3858,3471
2021-2022,8,03,Capitale-Nationale,CHU DE QUÉBEC - UNIVERSITÉ LAVAL,HÔPITAL DU SAINT-SACREMENT,51217529,21637,4412,601,7.6161882552,17575,2.0399853801,15904,1895,249,3.6416469302,11860,2.4351114859,5733,1588,418,18.642022065,5715,1.2200036454,2517,352
2021-2022,8,03,Capitale-Nationale,CHU DE QUÉBEC - UNIVERSITÉ LAVAL,HÔPITAL SAINT-FRANÇOIS D'ASSISE,51217602,25786,5275,870,9.3743589329,20859,2.0700858542,16027,1647,400,4.2288936032,11125,2.7982068664,9759,2677,419,17.824648188,9734,1.2379154967,3628,470
2021-2022,8,03,Capitale-Nationale,CHU DE QUÉBEC - UNIVERSITÉ LAVAL,L'HÔTEL-DIEU DE QUÉBEC,51217586,11441,2830,619,8.5268989939,10470,1.6337066221,5790,773,254,3.5610139609,4862,1.8525338224,5651,855,43,13.614931969,5608,1.4439887462,2057,365
2021-2022,8,03,Capitale-Nationale,CIUSSS DE LA CAPITALE-NATIONALE,CENTRE MULTISERVICES DE SANTÉ ET DE SERVICES SOCIAUX CHAUVEAU,51225001,16042,1102,229,3.4477465057,11676,1.9576957482,14704,960,190,3.3110067933,10352,2.0519541581,1338,0,0,4.9504525826,1324,1.2207145854,142,39
2021-2022,8,03,Capitale-Nationale,CIUSSS DE LA CAPITALE-NATIONALE,CENTRE MULTISERVICES DE SANTÉ ET DE SERVICES SOCIAUX DE BAIE-SAINT-PAUL,51244804,7038,1212,222,3.9339581557,5807,1.5113489467,5445,669,92,2.4670429038,4220,1.7002547393,1593,49,0,8.9479905141,1587,1.0090285654,543,130
2021-2022,8,03,Capitale-Nationale,CIUSSS DE LA CAPITALE-NATIONALE,CENTRE MULTISERVICES DE SANTÉ ET DE SERVICES SOCIAUX DE SAINT-MARC-DES-CARRIÈRES,51247344,9670,1292,236,3.1364402218,7838,1.5941465368,7926,727,146,2.4739109331,6122,1.8352644379,1744,24,0,6.1474534913,1716,0.7339345377,565,90
2021-2022,8,03,Capitale-Nationale,CIUSSS DE LA CAPITALE-NATIONALE,CENTRE MULTISERVICES DE SANTÉ ET DE SERVICES SOCIAUX DE SAINT-RAYMOND,51247302,12432,1459,255,3.8122563859,9781,2.1876698872,10006,798,156,3.0338773125,7393,2.5268604686,2426,50,4,7.0226690025,2388,1.137571073,661,99
2021-2022,8,03,Capitale-Nationale,CIUSSS DE LA CAPITALE-NATIONALE,CENTRE MULTISERVICES DE SANTÉ ET DE SERVICES SOCIAUX DE SAINTE-ANNE-DE-BEAUPRÉ,51225357,10709,1105,171,3.4086123821,8037,1.7659163867,9484,737,131,2.815170814,6825,1.888658079,1225,40,3,8.0030612245,1212,1.0747348276,368,40
2021-2022,8,03,Capitale-Nationale,CIUSSS DE LA CAPITALE-NATIONALE,HÔPITAL ET CLSC DE LA MALBAIE,51228690,8719,1400,297,4.8807683412,7324,1.7452754263,7078,845,173,3.138327682,5687,1.9980550183,1641,187,17,12.396304591,1637,0.86710955,555,124
2021-2022,8,03,Capitale-Nationale,INSTITUT UNIVERSITAIRE DE CARDIOLOGIE ET DE PNEUMOLOGIE DE QUÉBEC - UNIVERSITÉ LAVAL,INSTITUT UNIVERSITAIRE DE CARDIOLOGIE ET DE PNEUMOLOGIE DE QUÉBEC,51232130,16621,4962,391,7.4519903703,15739,1.7522222752,8708,1717,220,3.8555362566,7839,2.1942514989,7913,617,0,11.409771543,7900,1.3136061885,3245,171
2021-2022,8,04,Mauricie et Centre-du-Québec,CIUSSS DE LA MAURICIE-ET-DU-CENTRE-DU-QUÉBEC,CENTRE MULTISERVICES DE SANTÉ ET DE SERVICES SOCIAUX AVELLIN-DALCOURT,51233583,12974,1756,338,5.2950401872,10793,3.2658658647,10896,969,245,4.5615179883,8729,3.6832367523,2078,62,1,9.1412663084,2064,1.5007348191,787,93
2021-2022,8,04,Mauricie et Centre-du-Québec,CIUSSS DE LA MAURICIE-ET-DU-CENTRE-DU-QUÉBEC,CENTRE MULTISERVICES DE SANTÉ ET DE SERVICES SOCIAUX CHRIST-ROI,51246338,12984,1291,396,4.8714661635,10260,3.3918031189,10997,650,250,3.9275875744,8316,3.6109447651,1987,129,4,10.095337751,1944,2.4543638546,641,146
2021-2022,8,04,Mauricie et Centre-du-Québec,CIUSSS DE LA MAURICIE-ET-DU-CENTRE-DU-QUÉBEC,CENTRE MULTISERVICES DE SANTÉ ET DE SERVICES SOCIAUX DE FORTIERVILLE,51219160,8752,701,162,2.1702118881,7303,1.5377164255,8089,607,143,2.0587787256,6642,1.5954092643,663,0,0,3.5297637004,661,0.9579950412,94,19
2021-2022,8,04,Mauricie et Centre-du-Québec,CIUSSS DE LA MAURICIE-ET-DU-CENTRE-DU-QUÉBEC,CENTRE MULTISERVICES DE SANTÉ ET DE SERVICES SOCIAUX DU HAUT-SAINT-MAURICE,51219731,7053,1059,396,4.9468323172,6107,2.5826098921,5252,555,211,3.8045977194,4346,2.8321221302,1801,43,1,8.2777685237,1761,1.9668346583,504,185
2021-2022,8,04,Mauricie et Centre-du-Québec,CIUSSS DE LA MAURICIE-ET-DU-CENTRE-DU-QUÉBEC,HÔPITAL DU CENTRE-DE-LA-MAURICIE,51220051,21729,3851,1462,6.2463604706,16756,2.5962673404,13246,1080,305,4.0604033503,8354,3.5782003964,8483,406,2,9.6596798172,8402,1.6199439948,2771,1157
2021-2022,8,04,Mauricie et Centre-du-Québec,CIUSSS DE LA MAURICIE-ET-DU-CENTRE-DU-QUÉBEC,HÔPITAL SAINTE-CROIX,51228781,25747,3518,1684,7.3347674271,19783,3.0930382848,16545,1094,720,5.229571371,10804,3.8191215188,9202,813,2,11.119865096,8979,2.2193771578,2424,964
2021-2022,8,04,Mauricie et Centre-du-Québec,CIUSSS DE LA MAURICIE-ET-DU-CENTRE-DU-QUÉBEC,HÔTEL-DIEU D'ARTHABASKA,51228039,21774,3597,1314,5.8449140412,17228,2.3193480252,12906,1126,309,3.5650343509,8544,2.8637367353,8868,518,7,9.1629256879,8684,1.7837357337,2471,1005
2021-2022,8,04,Mauricie et Centre-du-Québec,CIUSSS DE LA MAURICIE-ET-DU-CENTRE-DU-QUÉBEC,PAVILLON SAINTE-MARIE,51220168,37339,7629,2356,9.7251106231,27767,3.3260016386,20931,1729,718,5.3182503756,11568,4.8920585523,16408,3577,176,15.346758102,16199,2.2076519641,5900,1638
2021-2022,8,05,Estrie,CIUSSS DE L'ESTRIE - CENTRE HOSPITALIER UNIVERSITAIRE DE SHERBROOKE,CENTRE DE SANTÉ ET DE SERVICES SOCIAUX DU GRANIT,51223832,8632,1329,313,6.4258865591,7362,3.4389262429,6854,745,205,5.0195082758,5595,3.7420263628,1778,170,16,11.847324553,1767,2.4791949632,584,108
2021-2022,8,05,Estrie,CIUSSS DE L'ESTRIE - CENTRE HOSPITALIER UNIVERSITAIRE DE SHERBROOKE,CENTRE MULTISERVICES DE SANTÉ ET DE SERVICES SOCIAUX DE LA MRC DE COATICOOK,51247617,9400,785,273,3.3258371749,7970,2.2210354803,7029,401,175,2.6963259354,5672,2.1909487149,2371,33,4,5.1920685131,2298,2.2952966348,384,98
2021-2022,8,05,Estrie,CIUSSS DE L'ESTRIE - CENTRE HOSPITALIER UNIVERSITAIRE DE SHERBROOKE,CENTRE MULTISERVICES DE SANTÉ ET DE SERVICES SOCIAUX DE MEMPHRÉMAGOG,51219046,13285,2611,476,6.4737920796,11060,2.8041450673,9261,1090,226,4.0214452183,7125,3.1486684211,4024,554,85,12.117724555,3935,2.18032578,1521,250
2021-2022,8,05,Estrie,CIUSSS DE L'ESTRIE - CENTRE HOSPITALIER UNIVERSITAIRE DE SHERBROOKE,CENTRE MULTISERVICES DE SANTÉ ET DE SERVICES SOCIAUX DES SOURCES,51247583,10067,1090,308,4.980153113,8072,3.4365020372,8917,711,249,4.4100532067,6933,3.6641250781,1150,50,5,9.4006582126,1139,2.0509791728,379,59
2021-2022,8,05,Estrie,CIUSSS DE L'ESTRIE - CENTRE HOSPITALIER UNIVERSITAIRE DE SHERBROOKE,CHUS - HÔPITAL FLEURIMONT,51216687,28541,3570,721,8.0149124651,24560,2.4041693811,15336,687,312,5.3244196661,11360,3.8080487089,13205,1370,54,11.139592326,13200,1.1959823232,2883,409
2021-2022,8,05,Estrie,CIUSSS DE L'ESTRIE - CENTRE HOSPITALIER UNIVERSITAIRE DE SHERBROOKE,CHUS - HÔTEL-DIEU DE SHERBROOKE,51216695,29071,5207,3541,9.5100724663,24348,2.5340999945,14049,1191,765,4.7682966759,9356,3.7920852929,15022,2493,516,13.944715528,14992,1.7490339292,4016,2776
2021-2022,8,05,Estrie,CIUSSS DE L'ESTRIE - CENTRE HOSPITALIER UNIVERSITAIRE DE SHERBROOKE,HÔPITAL BROME-MISSISQUOI-PERKINS,51229185,16907,2527,498,9.0557008767,13734,3.3448491578,11865,861,247,5.1894521702,8743,3.8339749577,5042,1284,387,18.153884316,4991,2.4880214942,1666,251
2021-2022,8,05,Estrie,CIUSSS DE L'ESTRIE - CENTRE HOSPITALIER UNIVERSITAIRE DE SHERBROOKE,HÔPITAL DE GRANBY,51228120,23522,3581,1531,9.6990086704,18451,3.5984856286,16135,1253,596,5.7471198223,11111,4.559701297,7387,2109,432,18.330892597,7340,2.1434355889,2328,935
2021-2022,8,06,Montréal,CENTRE HOSPITALIER DE L'UNIVERSITÉ DE MONTRÉAL,CENTRE HOSPITALIER DE L'UNIVERSITÉ DE MONTRÉAL,51236297,38932,5675,3064,13.100367057,31445,2.9683688009,23737,1703,1118,6.9727193949,16371,4.2578515363,15195,5638,1394,22.67272458,15074,1.5679361446,3972,1946
2021-2022,8,06,Montréal,CENTRE HOSPITALIER UNIVERSITAIRE SAINTE-JUSTINE,CHU SAINTE-JUSTINE,51222800,52019,1,1416,5.4357536456,45347,2.0292261708,36200,1,715,4.7610315838,30025,2.3674608197,15819,211,0,6.9797790983,15322,1.3664213585,0,701
2021-2022,8,06,Montréal,CENTRE UNIVERSITAIRE DE SANTÉ MCGILL,HÔPITAL DE LACHINE,51228310,10185,1796,434,9.420178776,9342,2.3563664098,6974,674,160,4.1440584871,6175,2.4522930724,3211,888,343,20.879432247,3167,2.1693291057,1122,274
2021-2022,8,06,Montréal,CENTRE UNIVERSITAIRE DE SANTÉ MCGILL,HÔPITAL GÉNÉRAL DE MONTRÉAL,51248219,19716,3141,2361,13.354958536,17023,1.86276598,7243,511,419,5.4463212757,4670,2.6713461813,12473,2886,975,17.947459112,12353,1.5570856157,2630,1942
2021-2022,8,06,Montréal,CENTRE UNIVERSITAIRE DE SANTÉ MCGILL,HÔPITAL ROYAL VICTORIA,51223295,29607,4534,695,14.508694659,23374,3.7515915476,19585,1432,354,7.7568731314,13458,4.6537775136,10022,3909,1761,27.703109409,9916,2.5271443178,3102,341
2021-2022,8,06,Montréal,CENTRE UNIVERSITAIRE DE SANTÉ MCGILL,L'HÔPITAL DE MONTRÉAL POUR ENFANTS,51223279,45718,1,1613,6.2948931189,40612,2.2376909671,35604,0,525,5.5153117159,30546,2.6404294616,10114,395,24,9.0392293136,10066,1.0155520785,1,1088
2021-2022,8,06,Montréal,CIUSSS DE L'EST-DE-L'ÎLE-DE-MONTRÉAL,HÔPITAL MAISONNEUVE-ROSEMONT,12934659,40067,6984,3342,12.256134253,29218,3.7556977434,22883,1541,860,5.7924403366,12283,5.1397642405,17184,5720,1474,20.863484572,16935,2.7518306761,5443,2482
2021-2022,8,06,Montréal,CIUSSS DE L'EST-DE-L'ÎLE-DE-MONTRÉAL,HÔPITAL SANTA CABRINI,51235919,20442,4833,762,12.631635644,17357,2.9960964356,12247,1192,293,5.6099444989,9186,4.1598238261,8195,2900,1015,23.125186767,8171,1.6878110594,3641,469
2021-2022,8,06,Montréal,CIUSSS DE L'EST-DE-L'ÎLE-DE-MONTRÉAL,INSTITUT UNIVERSITAIRE EN SANTÉ MENTALE DE MONTRÉAL,51235307,2798,101,2791,15.794478695,2713,1.1800410575,1282,23,1277,3.4706209915,1198,1.3601395845,1516,679,226,26.216105064,1515,1.0376265127,78,1514
2021-2022,8,06,Montréal,CIUSSS DE L'OUEST-DE-L'ÎLE-DE-MONTRÉAL,CENTRE HOSPITALIER DE ST. MARY,51248243,20789,3886,1584,9.5697009637,19516,2.0810220247,13891,1287,516,5.0702977747,12624,2.4859347935,6898,1873,240,18.630473607,6892,1.3393477945,2599,1068
2021-2022,8,06,Montréal,CIUSSS DE L'OUEST-DE-L'ÎLE-DE-MONTRÉAL,HÔPITAL DE LASALLE,51224392,15880,2162,508,9.6320412643,12944,3.6237699148,11832,816,205,6.1613738168,8934,4.2528290799,4048,1169,346,19.776541571,4010,2.2222700194,1346,303
2021-2022,8,06,Montréal,CIUSSS DE L'OUEST-DE-L'ÎLE-DE-MONTRÉAL,HÔPITAL DOUGLAS,51235190,3824,73,3652,7.2269148071,3437,2.2393047069,2163,35,1995,3.6133167668,1777,2.1921129557,1661,182,5,11.932641816,1660,2.2898226238,38,1657
2021-2022,8,06,Montréal,CIUSSS DE L'OUEST-DE-L'ÎLE-DE-MONTRÉAL,HÔPITAL GÉNÉRAL DU LAKESHORE,51228278,24031,4772,1380,14.125252047,20164,2.9117613348,15232,1416,210,7.3677558393,11393,3.7949755942,8799,3380,1509,25.823192976,8771,1.7645192807,3356,1170
2021-2022,8,06,Montréal,CIUSSS DU CENTRE-OUEST-DE-L'ÎLE-DE-MONTRÉAL,HÔPITAL GÉNÉRAL JUIF,51248250,53019,9169,2723,9.0635577707,48094,1.8948504029,22635,1354,392,4.0598334438,18251,2.1226946012,30384,4067,771,12.791154537,29843,1.7555083641,7815,2331
2021-2022,8,06,Montréal,CIUSSS DU CENTRE-SUD-DE-L'ÎLE-DE-MONTRÉAL,HÔPITAL DE VERDUN,51218097,23330,3647,1840,9.1905212054,20948,1.7754588081,15340,1169,671,3.8457740294,12993,2.1956588804,7990,2658,380,19.45190064,7955,1.0891408269,2478,1169
2021-2022,8,06,Montréal,CIUSSS DU CENTRE-SUD-DE-L'ÎLE-DE-MONTRÉAL,HÔPITAL NOTRE-DAME,51236313,21986,2798,3032,12.743278741,18490,2.5789966048,14340,761,1382,5.9276141911,10874,3.3929988454,7646,2979,1035,25.525992531,7616,1.4167775444,2037,1650
2021-2022,8,06,Montréal,CIUSSS DU NORD-DE-L'ÎLE-DE-MONTRÉAL,HÔPITAL DU SACRÉ-COEUR-DE-MONTRÉAL,12475976,36867,6775,1749,11.408734369,30975,2.5344818312,23760,1964,791,5.7335462729,17894,3.5063471462,13107,4725,1409,21.696555318,13081,1.2050301115,4811,958
2021-2022,8,06,Montréal,CIUSSS DU NORD-DE-L'ÎLE-DE-MONTRÉAL,HÔPITAL EN SANTÉ MENTALE ALBERT-PRÉVOST,51848752,2042,81,2030,19.272690989,2009,0.2412644489,915,29,903,3.854972374,882,0.3694699546,1127,626,218,31.790182145,1127,0.1409297052,52,1127
2021-2022,8,06,Montréal,CIUSSS DU NORD-DE-L'ÎLE-DE-MONTRÉAL,HÔPITAL FLEURY,51228492,18777,2922,801,8.9120275692,14047,3.4653871329,14133,1166,410,5.6845509328,9418,4.215333817,4644,1384,102,18.734148005,4629,1.9395720818,1756,391
2021-2022,8,06,Montréal,CIUSSS DU NORD-DE-L'ÎLE-DE-MONTRÉAL,HÔPITAL JEAN-TALON,51228500,23837,3053,1920,7.9826350725,18809,3.115588356,17676,959,853,5.3824814249,12664,3.9886756861,6161,1283,81,15.442514292,6145,1.3162754272,2094,1067
2021-2022,8,06,Montréal,INSTITUT DE CARDIOLOGIE DE MONTRÉAL,INSTITUT DE CARDIOLOGIE DE MONTRÉAL,51248201,10921,2899,344,9.3031660715,10609,1.4551007007,6673,1159,293,3.5319359109,6364,1.6621540436,4248,1243,110,18.36894264,4245,1.1446914016,1740,51
2021-2022,8,07,Outaouais,CISSS DE L'OUTAOUAIS,CENTRE MULTISERVICES DE SANTÉ ET DE SERVICES SOCIAUX DE MANSFIELD-ET-PONTEFRACT,51245058,5346,571,176,4.1010944839,5110,1.3449803762,5163,536,167,3.9338809262,4927,1.3338290711,183,6,0,8.8187097753,183,1.6452125076,35,9
2021-2022,8,07,Outaouais,CISSS DE L'OUTAOUAIS,CLSC ET CENTRE D'HÉBERGEMENT DE LA PETITE-NATION,51219491,6285,716,282,2.9429786529,5480,1.3827873074,5714,552,254,2.7614192237,4910,1.4521415479,571,1,0,4.7598448142,570,0.7853674464,164,28
2021-2022,8,07,Outaouais,CISSS DE L'OUTAOUAIS,HÔPITAL DE GATINEAU,51221703,18071,2069,2570,10.120237489,11977,2.4730693552,11788,824,672,3.5554653744,5788,2.6455927014,6283,1893,911,22.436890949,6189,2.311724206,1245,1898
2021-2022,8,07,Outaouais,CISSS DE L'OUTAOUAIS,HÔPITAL DE HULL,51221711,21175,3685,976,11.086560488,15277,2.6561404035,13033,1085,583,4.7377261567,7251,2.9883436384,8142,2264,964,21.249218046,8026,2.3560151037,2600,393
2021-2022,8,07,Outaouais,CISSS DE L'OUTAOUAIS,HÔPITAL DE MANIWAKI,51221893,7662,1045,433,7.2551341759,6729,2.3338309308,5363,518,246,3.6590577931,4512,2.3811895439,2299,387,224,15.64389348,2217,2.2374475016,527,187
2021-2022,8,07,Outaouais,CISSS DE L'OUTAOUAIS,HÔPITAL ET CHSLD DE PAPINEAU,51228823,12634,1525,641,7.6891919732,9042,3.0180801322,9118,596,223,3.3857060211,5581,3.0923678552,3516,915,221,18.849369707,3461,2.8982882276,929,418
2021-2022,8,07,Outaouais,CISSS DE L'OUTAOUAIS,HÔPITAL ET CHSLD DU PONTIAC,51219459,5625,693,147,4.8729466667,5141,1.9247510752,4978,547,117,4.2727716397,4494,1.9853814345,647,42,1,9.4906766272,647,1.5036184098,146,30
2021-2022,8,07,Outaouais,CISSS DE L'OUTAOUAIS,HÔPITAL ET CHSLD MÉMORIAL DE WAKEFIELD / WAKEFIELD MEMORIAL HOSPITAL,51228799,8191,670,247,5.1469125666,6972,2.3415020001,7256,471,192,3.9505902778,6053,2.3915444132,935,171,25,14.430885324,919,2.0118972917,199,55
2021-2022,8,08,Abitibi-Témiscamingue,CISSS DE L'ABITIBI-TÉMISCAMINGUE,CENTRE MULTISERVICES DE SANTÉ ET DE SERVICES SOCIAUX DE LA SARRE,51247559,11118,1221,600,4.8321674812,9961,1.9692461991,9623,789,516,4.195804958,8482,2.0586184142,1495,80,8,8.9282989595,1479,1.4567004733,432,84
2021-2022,8,08,Abitibi-Témiscamingue,CISSS DE L'ABITIBI-TÉMISCAMINGUE,CENTRE MULTISERVICES DE SANTÉ ET DE SERVICES SOCIAUX DE TÉMISCAMING-KIPAWA,51247476,3008,305,179,2.2788628472,2842,0.6588568301,2971,290,172,2.1569670706,2805,0.6604422658,37,0,0,12.066764264,37,0.5386636637,15,7
2021-2022,8,08,Abitibi-Témiscamingue,CISSS DE L'ABITIBI-TÉMISCAMINGUE,CENTRE MULTISERVICES DE SANTÉ ET DE SERVICES SOCIAUX DE VILLE-MARIE,51247542,7428,956,409,5.0552310701,6404,2.8922272104,6708,716,337,4.4604367505,5692,2.9601310807,720,30,1,10.596731481,712,2.349377731,240,72
2021-2022,8,08,Abitibi-Témiscamingue,CISSS DE L'ABITIBI-TÉMISCAMINGUE,HÔPITAL D'AMOS,51228906,12865,1248,536,4.499045062,10981,1.2774968127,9742,532,405,2.4168672016,7878,1.4524950989,3123,359,58,10.994266553,3103,0.833205321,716,131
2021-2022,8,08,Abitibi-Témiscamingue,CISSS DE L'ABITIBI-TÉMISCAMINGUE,HÔPITAL DE ROUYN-NORANDA,51228922,16300,1889,969,6.2376006305,12111,3.4229126185,13060,927,605,5.271790114,8914,3.9244339429,3240,227,10,10.130651663,3197,2.0245513155,962,364
2021-2022,8,08,Abitibi-Témiscamingue,CISSS DE L'ABITIBI-TÉMISCAMINGUE,HÔPITAL DE VAL-D'OR,51225589,16664,1673,1285,7.5676579253,12765,4.0871747835,13442,900,928,5.6797794847,9553,4.8006713423,3222,681,117,15.443778968,3212,1.9651222845,773,357
2021-2022,8,09,Côte-Nord,CISSS DE LA CÔTE-NORD,CENTRE MULTISERVICES DE SANTÉ ET DE SERVICES SOCIAUX DE FERMONT,51245108,3296,8,150,6.705201844,2775,1.3856660661,3168,7,143,6.6810547313,2647,1.4051068295,128,7,3,7.3028428819,128,0.9836371528,1,7
2021-2022,8,09,Côte-Nord,CISSS DE LA CÔTE-NORD,CENTRE MULTISERVICES DE SANTÉ ET DE SERVICES SOCIAUX DE FORESTVILLE,51218741,6490,937,284,3.3745149803,5227,1.8466208575,5588,665,217,2.8473958582,4434,1.9604214279,902,24,3,6.6400822247,793,1.2103135071,272,67
2021-2022,8,09,Côte-Nord,CISSS DE LA CÔTE-NORD,CENTRE MULTISERVICES DE SANTÉ ET DE SERVICES SOCIAUX DE LA BASSE-CÔTE-NORD,51245140,2235,287,113,3.3550484713,2163,1.2040681666,1844,204,103,3.2014767113,1778,1.2401290464,391,0,0,4.0793101733,385,1.0375324675,83,10
2021-2022,8,09,Côte-Nord,CISSS DE LA CÔTE-NORD,CENTRE MULTISERVICES DE SANTÉ ET DE SERVICES SOCIAUX DE LA MINGANIE,51245116,8530,627,253,2.4494238635,4285,1.9388586153,6379,422,113,1.5934088851,2230,2.0869055805,2151,23,1,4.9880196549,2055,1.7782042444,205,140
2021-2022,8,09,Côte-Nord,CISSS DE LA CÔTE-NORD,CENTRE MULTISERVICES DE SANTÉ ET DE SERVICES SOCIAUX DE PORT-CARTIER,51245132,8009,595,382,4.1443919688,7103,1.9479779279,7276,426,310,3.0307409825,6378,2.0543224975,733,115,34,15.19885933,725,1.0124390805,169,72
2021-2022,8,09,Côte-Nord,CISSS DE LA CÔTE-NORD,CENTRE MULTISERVICES DE SANTÉ ET DE SERVICES SOCIAUX DES ESCOUMINS,51218733,5413,754,185,3.3645777141,4843,1.3105127676,4786,518,160,2.7892130403,4219,1.3639073899,627,20,5,7.7564362928,624,0.949500089,236,25
2021-2022,8,09,Côte-Nord,CISSS DE LA CÔTE-NORD,CLSC ET HÔPITAL LE ROYER,51228765,12785,1924,1009,10.386917634,11223,3.5071090122,9339,824,618,5.5767724655,7786,4.0285943074,3446,1058,524,23.422885632,3437,2.325763505,1100,391
2021-2022,8,09,Côte-Nord,CISSS DE LA CÔTE-NORD,HÔPITAL ET CLSC DE SEPT-ÎLES,51232023,12791,1495,918,10.488920726,10015,3.1493480058,8369,577,341,4.203132327,5714,3.3330635282,4422,1115,567,22.38529411,4301,2.9052767444,918,577
2021-2022,8,11,Gaspésie-Îles-de-la-Madeleine,CISSS DE LA GASPÉSIE,CENTRE MULTISERVICES DE SANTÉ ET DE SERVICES SOCIAUX DE GRANDE-VALLÉE,51247732,3523,564,69,1.6072194626,2563,0.7833586942,3195,446,54,1.2861384977,2301,0.8060694626,328,6,2,4.7348221545,262,0.5839026718,118,15
2021-2022,8,11,Gaspésie-Îles-de-la-Madeleine,CISSS DE LA GASPÉSIE,CLSC ET CENTRE DE SERVICES AMBULATOIRES DE MURDOCHVILLE,51221307,1051,166,59,3.1492063114,1007,1.6673366987,1044,164,59,3.1095213389,1000,1.6725444444,7,0,0,9.0679365079,7,0.9233730159,2,0
2021-2022,8,11,Gaspésie-Îles-de-la-Madeleine,CISSS DE LA GASPÉSIE,CLSC ET CENTRE DE SERVICES AMBULATOIRES DE PASPÉBIAC,51220978,7378,1297,298,3.7561569682,6728,1.7765195204,5550,828,233,2.9803196697,4994,1.8700048391,1828,48,7,6.1116804948,1734,1.5072774894,469,65
2021-2022,8,11,Gaspésie-Îles-de-la-Madeleine,CISSS DE LA GASPÉSIE,HÔPITAL DE CHANDLER,51227775,8718,1470,368,5.1726922587,7739,1.8081072777,7209,918,292,3.5570377306,6238,1.9669973905,1509,171,15,12.891216773,1501,1.1477764823,552,76
2021-2022,8,11,Gaspésie-Îles-de-la-Madeleine,CISSS DE LA GASPÉSIE,HÔPITAL DE GASPÉ,51220903,8642,1362,384,4.839800972,7618,1.5138797366,6886,759,279,3.4208833946,5872,1.7204249451,1756,110,1,10.403961813,1746,0.8192443044,603,105
2021-2022,8,11,Gaspésie-Îles-de-la-Madeleine,CISSS DE LA GASPÉSIE,HÔPITAL ET CLSC DE SAINTE-ANNE-DES-MONTS,51247799,8337,1281,363,4.2958382645,7475,1.4872841695,6733,722,270,2.3811942835,5881,1.5355038826,1604,206,65,12.332807045,1594,1.3093794437,559,93
2021-2022,8,11,Gaspésie-Îles-de-la-Madeleine,CISSS DE LA GASPÉSIE,HÔPITAL ET GROUPE DE MÉDECINE DE FAMILLE UNIVERSITAIRE DE MARIA,51227908,10003,1688,487,8.3192009342,9033,2.2812724332,7245,774,225,4.2466572732,6284,2.559332299,2758,830,250,19.017380348,2749,1.645649226,914,262
2021-2022,8,11,Gaspésie-Îles-de-la-Madeleine,CISSS DES ÎLES,HÔPITAL DE L'ARCHIPEL,51227783,9831,1222,300,3.3577630003,8557,1.0525529456,8191,826,167,2.2233741301,6924,1.1219737708,1640,83,2,9.0234820461,1633,0.758205246,396,133
2021-2022,8,12,Chaudière-Appalaches,CISSS DE CHAUDIÈRE-APPALACHES,CHSLD ET HÔPITAL PAUL-GILBERT,51245199,6283,382,99,2.3799299698,5360,1.3790443615,5880,346,89,2.3063179327,4959,1.4398883063,403,0,0,3.4539716019,401,0.6266126351,36,10
2021-2022,8,12,Chaudière-Appalaches,CISSS DE CHAUDIÈRE-APPALACHES,HÔPITAL DE MONTMAGNY,51245223,19896,2909,691,4.2806651253,18237,1.3823928917,15110,1394,321,2.444544893,13457,1.6108278839,4786,244,1,10.077526118,4780,0.7392862622,1515,370
2021-2022,8,12,Chaudière-Appalaches,CISSS DE CHAUDIÈRE-APPALACHES,HÔPITAL DE SAINT-GEORGES,51228971,24402,4014,1299,6.2876507732,20151,2.0665560435,16682,1422,570,3.5333776259,12452,2.5356230146,7720,785,16,12.239306815,7699,1.3079092162,2592,729
2021-2022,8,12,Chaudière-Appalaches,CISSS DE CHAUDIÈRE-APPALACHES,HÔPITAL DE THETFORD,51245231,22106,3417,698,5.6027263086,19437,1.3119374275,17017,1679,339,3.6481159364,14348,1.4843922111,5089,560,13,12.138706797,5089,0.8257159232,1738,359
2021-2022,8,12,Chaudière-Appalaches,CISSS DE CHAUDIÈRE-APPALACHES,HÔTEL-DIEU DE LÉVIS,51227569,49761,8315,3065,6.6027689802,42276,1.0617597586,34980,3057,1482,2.6762884664,27497,1.3273206673,14781,3392,418,15.894987935,14779,0.5676716399,5258,1583
2021-2022,8,13,Laval,CISSS DE LAVAL,HÔPITAL DE LA CITÉ-DE-LA-SANTÉ,51228757,55756,8940,3498,8.273610578,42666,2.8768544495,37066,2739,1042,4.9177766237,24032,3.6700023233,18690,3029,191,14.92889904,18634,1.8539431207,6201,2456
2021-2022,8,14,Lanaudière,CISSS DE LANAUDIÈRE,HÔPITAL DE LANAUDIÈRE ET CENTRE D'HÉBERGEMENT PARPHILIA-FERLAND,51244945,40878,6619,2881,9.2323780042,34177,2.4051572858,25982,1881,2002,5.3181730942,19385,3.0881709942,14896,3575,503,16.059638475,14792,1.5100639422,4738,879
2021-2022,8,14,Lanaudière,CISSS DE LANAUDIÈRE,HÔPITAL PIERRE-LE GARDEUR,51228062,46105,7101,2634,10.552869398,30763,4.6895160041,31461,2439,978,6.5712286376,16189,6.1694674024,14644,4800,426,19.106980295,14574,3.0455656001,4662,1656
2021-2022,8,15,Laurentides,CISSS DES LAURENTIDES,CENTRE MULTISERVICES DE SANTÉ ET DE SERVICES SOCIAUX D'ARGENTEUIL,51245306,12696,1511,497,8.1524428079,10643,3.2599878637,10453,825,336,5.2316000723,8408,3.6202249181,2243,736,210,21.764377322,2235,1.9047873478,686,161
2021-2022,8,15,Laurentides,CISSS DES LAURENTIDES,CENTRE MULTISERVICES DE SANTÉ ET DE SERVICES SOCIAUX DE RIVIÈRE-ROUGE,51217628,8812,1031,515,6.3694672038,7799,2.4023095554,6743,540,245,3.4135474649,5766,2.5418828285,2069,435,130,16.002993932,2033,2.0064514675,491,270
2021-2022,8,15,Laurentides,CISSS DES LAURENTIDES,CENTRE MULTISERVICES DE SANTÉ ET DE SERVICES SOCIAUX DE SAINTE-AGATHE,51246874,18435,2905,1199,12.312132372,14449,4.1699314062,12288,1145,363,7.1296845387,8366,5.2566971472,6147,2122,639,22.671969524,6083,2.6752935321,1760,836
2021-2022,8,15,Laurentides,CISSS DES LAURENTIDES,HÔPITAL DE MONT-LAURIER,51217610,10385,1413,573,8.8000563847,8407,3.2891368965,7939,705,327,6.0193032988,6011,3.5989019668,2446,614,158,17.825566912,2396,2.5120092515,708,246
2021-2022,8,15,Laurentides,CISSS DES LAURENTIDES,HÔPITAL DE SAINT-EUSTACHE,51228864,29361,5314,1710,11.998132585,20899,3.2869995773,17582,1433,579,6.0631096039,9176,4.9736214037,11779,3953,1162,20.857082756,11723,1.9668219881,3881,1131
2021-2022,8,15,Laurentides,CISSS DES LAURENTIDES,HÔPITAL DE SAINT-JÉRÔME,51228880,33304,5466,3125,16.15666655,23728,4.6636537822,20022,1724,967,7.6814459789,10526,6.5041453966,13282,5748,2672,28.93266913,13202,3.1962234889,3742,2158
2021-2022,8,16,Montérégie,CISSS DE LA MONTÉRÉGIE-CENTRE,HÔPITAL CHARLES-LE MOYNE,51233799,46850,7582,3967,9.6886717479,26518,4.7085905171,32905,2831,1761,5.565011177,12581,5.8437787139,13945,4434,473,19.418973009,13937,3.6838504221,4751,2206
2021-2022,8,16,Montérégie,CISSS DE LA MONTÉRÉGIE-CENTRE,HÔPITAL DU HAUT-RICHELIEU,51229045,38719,5597,2422,9.1267541632,29320,2.7782122556,27950,2127,980,4.9422737527,18596,3.4258586076,10769,3227,1190,19.98720801,10724,1.6551582121,3470,1442
2021-2022,8,16,Montérégie,CISSS DE LA MONTÉRÉGIE-EST,HÔPITAL HONORÉ-MERCIER,51229193,30087,5000,1773,8.500125331,22456,3.0739923505,22513,2079,909,4.579963737,14899,3.6844392055,7574,2346,649,20.152435598,7557,1.8704661241,2921,864
2021-2022,8,16,Montérégie,CISSS DE LA MONTÉRÉGIE-EST,HÔPITAL PIERRE-BOUCHER,51229011,34437,6213,2072,12.187661527,25324,3.6363879675,16885,1642,594,4.8965807094,7947,4.8422093243,17552,4835,2011,19.201671304,17377,3.0849313109,4571,1478
2021-2022,8,16,Montérégie,CISSS DE LA MONTÉRÉGIE-EST,HÔTEL-DIEU DE SOREL,51229102,20090,3295,1019,9.1124146203,16644,2.6791703383,13224,1326,332,5.1162381529,9840,3.3527591463,6866,1731,417,16.809099387,6804,1.7050207394,1969,687
2021-2022,8,16,Montérégie,CISSS DE LA MONTÉRÉGIE-OUEST,HÔPITAL ANNA-LABERGE,51229151,24306,4191,1406,14.046331507,18911,2.4121080324,15399,1143,391,7.3991016733,10004,3.3929628149,8907,3666,1266,25.5384941,8907,1.3104496463,3048,1015
2021-2022,8,16,Montérégie,CISSS DE LA MONTÉRÉGIE-OUEST,HÔPITAL BARRIE MEMORIAL / BARRIE MEMORIAL HOSPITAL,51228005,11920,1224,220,6.4113334265,9775,3.6435883774,9974,672,172,4.5833084074,7844,3.2570938863,1946,441,43,15.780666181,1931,5.2135846424,552,48
2021-2022,8,16,Montérégie,CISSS DE LA MONTÉRÉGIE-OUEST,HÔPITAL DU SUROÎT,51229136,22023,4414,1769,14.986994657,18072,2.2419411398,13740,1199,1156,4.7110921074,9858,3.0435393702,8283,2893,1786,32.032859807,8214,1.2799061562,3215,613
2022-2023,8,01,Bas-Saint-Laurent,CISSS DU BAS-SAINT-LAURENT,CENTRE HOSPITALIER RÉGIONAL DU GRAND-PORTAGE,51218352,13257,2268,628,5.1729094902,10980,2.2909846944,9746,932,375,3.3701954078,7496,2.546291096,3511,99,5,10.176968575,3484,1.7416802207,1336,253
2022-2023,8,01,Bas-Saint-Laurent,CISSS DU BAS-SAINT-LAURENT,CENTRE MULTISERVICES DE SANTÉ ET DE SERVICES SOCIAUX DE TROIS-PISTOLES,51236156,6835,963,184,3.221428107,6145,1.3917450954,5989,660,147,2.4837425558,5310,1.4761000209,846,45,1,8.4436488705,835,0.8553083832,303,37
2022-2023,8,01,Bas-Saint-Laurent,CISSS DU BAS-SAINT-LAURENT,CLSC DE POHÉNÉGAMOOK,51219418,6240,752,136,1.6454427528,5693,0.7441542245,5827,623,120,1.2974361211,5286,0.7517587863,413,6,0,6.5554539952,407,0.6453883429,129,16
2022-2023,8,01,Bas-Saint-Laurent,CISSS DU BAS-SAINT-LAURENT,HÔPITAL D'AMQUI,51226892,9908,1501,282,3.9815692146,8742,1.6666196713,5530,509,162,3.1052145871,4530,1.899099583,4378,22,2,5.08852241,4212,1.4165878574,992,120
2022-2023,8,01,Bas-Saint-Laurent,CISSS DU BAS-SAINT-LAURENT,HÔPITAL DE MATANE,51218980,11814,1933,462,4.7028428841,10422,2.6658961812,8871,959,246,4.1694348,7550,3.0085451435,2943,31,1,6.3106794843,2872,1.7651302809,974,216
2022-2023,8,01,Bas-Saint-Laurent,CISSS DU BAS-SAINT-LAURENT,HÔPITAL DE NOTRE-DAME-DU-LAC,51221877,8408,1341,228,3.7759000026,7557,1.4044479364,6722,716,114,2.314879996,5879,1.5539903801,1686,93,7,9.6009157111,1678,0.8805146669,625,114
2022-2023,8,01,Bas-Saint-Laurent,CISSS DU BAS-SAINT-LAURENT,HÔPITAL NOTRE-DAME-DE-FATIMA,51221141,10272,1589,272,3.347697246,9500,1.3955475439,8339,857,142,2.5128178172,7581,1.5069714124,1933,3,0,6.9493835144,1919,0.9553681026,732,130
2022-2023,8,01,Bas-Saint-Laurent,CISSS DU BAS-SAINT-LAURENT,HÔPITAL RÉGIONAL DE RIMOUSKI,51227882,20232,3411,974,5.6677050657,15541,2.5435117324,14643,1384,610,4.1503089076,9994,2.9913899173,5589,254,8,9.6432341305,5547,1.7365720209,2027,364
2022-2023,8,02,Saguenay-Lac-Saint-Jean,CIUSSS DU SAGUENAY - LAC-SAINT-JEAN,HÔPITAL D'ALMA,51219400,21682,3054,771,5.058625729,16927,2.8740816119,16762,1554,356,3.7947849633,12112,3.0874454398,4920,190,12,9.3644181911,4815,2.3373707742,1500,415
2022-2023,8,02,Saguenay-Lac-Saint-Jean,CIUSSS DU SAGUENAY - LAC-SAINT-JEAN,HÔPITAL DE CHICOUTIMI,51218394,33930,5111,2097,7.630773406,29071,2.5312456763,20046,1479,674,3.9331778576,15317,3.3587053782,13884,2054,349,12.969436642,13754,1.6097537282,3632,1423
2022-2023,8,02,Saguenay-Lac-Saint-Jean,CIUSSS DU SAGUENAY - LAC-SAINT-JEAN,HÔPITAL DE DOLBEAU-MISTASSINI,51219384,12895,2000,469,4.3475317953,11698,1.787710791,10840,1251,260,2.9434130279,9663,1.9157662389,2055,256,54,11.754172885,2035,1.1796519247,749,209
2022-2023,8,02,Saguenay-Lac-Saint-Jean,CIUSSS DU SAGUENAY - LAC-SAINT-JEAN,HÔPITAL DE LA BAIE,51221364,12251,1420,373,5.1982900262,11202,2.5583911107,9883,684,232,3.8845860737,8854,2.7910754085,2368,159,26,10.681117797,2348,1.6809691463,736,141
2022-2023,8,02,Saguenay-Lac-Saint-Jean,CIUSSS DU SAGUENAY - LAC-SAINT-JEAN,HÔPITAL ET CENTRE D'HÉBERGEMENT DE ROBERVAL,51228203,14961,2026,943,5.4181295814,13413,2.1844374032,10442,832,305,3.2575012503,8965,2.3769972733,4519,426,71,10.410667982,4448,1.7963305606,1194,638
2022-2023,8,02,Saguenay-Lac-Saint-Jean,CIUSSS DU SAGUENAY - LAC-SAINT-JEAN,HÔPITAL ET CENTRE DE RÉADAPTATION DE JONQUIÈRE,51224541,16195,2727,782,8.1090910775,12673,4.1198573739,10230,894,273,5.0935793147,6918,4.5154397947,5965,791,73,13.280706389,5755,3.6443336229,1833,509
2022-2023,8,03,Capitale-Nationale,CHU DE QUÉBEC - UNIVERSITÉ LAVAL,CENTRE HOSPITALIER DE L'UNIVERSITÉ LAVAL,51217594,47243,3414,4433,8.013412863,38074,2.0294605388,27010,714,1483,4.7582782097,17906,3.055354971,20233,2213,701,12.358847894,20168,1.118628245,2700,2950
2022-2023,8,03,Capitale-Nationale,CHU DE QUÉBEC - UNIVERSITÉ LAVAL,HÔPITAL DE L'ENFANT-JÉSUS,51233914,36326,5858,4430,10.755651638,32362,1.7009336224,20688,1913,1177,4.1140081206,16752,2.1486907036,15638,4314,1198,19.54208987,15610,1.2204194249,3945,3253
2022-2023,8,03,Capitale-Nationale,CHU DE QUÉBEC - UNIVERSITÉ LAVAL,HÔPITAL DU SAINT-SACREMENT,51217529,21636,4734,569,7.9601364624,17177,2.1434034044,15556,1961,198,3.7901837626,11122,2.5771141781,6080,1601,480,18.629179916,6055,1.3467508487,2773,371
2022-2023,8,03,Capitale-Nationale,CHU DE QUÉBEC - UNIVERSITÉ LAVAL,HÔPITAL SAINT-FRANÇOIS D'ASSISE,51217602,25310,5899,806,10.530397954,20535,2.0681064172,15550,1771,395,4.252713737,10803,2.7558907248,9760,3174,814,20.532241149,9732,1.304631913,4128,411
2022-2023,8,03,Capitale-Nationale,CHU DE QUÉBEC - UNIVERSITÉ LAVAL,L'HÔTEL-DIEU DE QUÉBEC,51217586,12170,3123,646,8.2034960741,10964,1.5611481009,6099,836,220,3.3671414713,4945,1.8089790473,6071,838,30,13.062156381,6019,1.3575388584,2287,426
2022-2023,8,03,Capitale-Nationale,CIUSSS DE LA CAPITALE-NATIONALE,CENTRE MULTISERVICES DE SANTÉ ET DE SERVICES SOCIAUX CHAUVEAU,51225001,27260,1831,340,3.2828945953,18124,2.1162678554,24836,1556,277,3.124733608,15755,2.2360910998,2424,0,0,4.9033922351,2369,1.3193851133,275,63
2022-2023,8,03,Capitale-Nationale,CIUSSS DE LA CAPITALE-NATIONALE,CENTRE MULTISERVICES DE SANTÉ ET DE SERVICES SOCIAUX DE BAIE-SAINT-PAUL,51244804,8488,1414,235,4.3560696146,6541,2.0156567973,6794,872,100,2.8614827626,4858,2.2755460066,1694,129,12,10.350298111,1683,1.2654834291,542,135
2022-2023,8,03,Capitale-Nationale,CIUSSS DE LA CAPITALE-NATIONALE,CENTRE MULTISERVICES DE SANTÉ ET DE SERVICES SOCIAUX DE SAINT-MARC-DES-CARRIÈRES,51247344,10545,1376,255,3.2090758917,8602,1.6880200018,8437,707,157,2.4829393018,6538,1.956455338,2108,30,3,6.1153445868,2064,0.8377146587,669,98
2022-2023,8,03,Capitale-Nationale,CIUSSS DE LA CAPITALE-NATIONALE,CENTRE MULTISERVICES DE SANTÉ ET DE SERVICES SOCIAUX DE SAINT-RAYMOND,51247302,12923,1582,224,4.2424341398,10087,2.327277574,10480,847,131,3.3150226092,7669,2.6890613364,2443,79,8,8.2208511848,2418,1.1798335401,735,93
2022-2023,8,03,Capitale-Nationale,CIUSSS DE LA CAPITALE-NATIONALE,CENTRE MULTISERVICES DE SANTÉ ET DE SERVICES SOCIAUX DE SAINTE-ANNE-DE-BEAUPRÉ,51225357,11487,1270,185,3.8293629514,8459,2.1327759717,9990,795,137,3.1620998777,7012,2.3196258398,1497,57,8,8.2822407779,1447,1.2273224295,475,48
2022-2023,8,03,Capitale-Nationale,CIUSSS DE LA CAPITALE-NATIONALE,HÔPITAL ET CLSC DE LA MALBAIE,51228690,9130,1490,257,5.6052255385,7497,1.8983461162,7291,878,155,3.3728981697,5673,2.1973710265,1839,298,73,14.455632741,1824,0.9683196272,612,102
2022-2023,8,03,Capitale-Nationale,INSTITUT UNIVERSITAIRE DE CARDIOLOGIE ET DE PNEUMOLOGIE DE QUÉBEC - UNIVERSITÉ LAVAL,INSTITUT UNIVERSITAIRE DE CARDIOLOGIE ET DE PNEUMOLOGIE DE QUÉBEC,51232130,16813,5343,387,8.1620672165,15866,1.9445188523,8566,1771,196,3.9723639323,7644,2.4448826967,8247,863,0,12.513831292,8222,1.4793301846,3572,191
2022-2023,8,04,Mauricie et Centre-du-Québec,CIUSSS DE LA MAURICIE-ET-DU-CENTRE-DU-QUÉBEC,CENTRE MULTISERVICES DE SANTÉ ET DE SERVICES SOCIAUX AVELLIN-DALCOURT,51233583,13659,1765,317,5.7573788345,10688,3.8238424193,11602,983,211,4.9359721265,8643,4.2791030314,2057,100,14,10.390320315,2045,1.8997262972,782,106
2022-2023,8,04,Mauricie et Centre-du-Québec,CIUSSS DE LA MAURICIE-ET-DU-CENTRE-DU-QUÉBEC,CENTRE MULTISERVICES DE SANTÉ ET DE SERVICES SOCIAUX CHRIST-ROI,51246338,14467,1443,376,5.6807748285,10669,4.0951496287,12381,754,251,4.7511378322,8617,4.3605374711,2086,177,28,11.198433339,2052,2.9807017544,689,125
2022-2023,8,04,Mauricie et Centre-du-Québec,CIUSSS DE LA MAURICIE-ET-DU-CENTRE-DU-QUÉBEC,CENTRE MULTISERVICES DE SANTÉ ET DE SERVICES SOCIAUX DE FORTIERVILLE,51219160,9246,773,164,2.277251424,7059,1.8490915852,8546,661,138,2.1627829459,6366,1.9278393025,700,0,0,3.6747480159,693,1.1257034632,112,26
2022-2023,8,04,Mauricie et Centre-du-Québec,CIUSSS DE LA MAURICIE-ET-DU-CENTRE-DU-QUÉBEC,CENTRE MULTISERVICES DE SANTÉ ET DE SERVICES SOCIAUX DU HAUT-SAINT-MAURICE,51219731,7676,1146,417,5.9035610633,6425,3.0290801989,5774,632,207,4.1410694011,4573,3.3135909444,1902,177,12,11.25404837,1852,2.3265598752,514,210
2022-2023,8,04,Mauricie et Centre-du-Québec,CIUSSS DE LA MAURICIE-ET-DU-CENTRE-DU-QUÉBEC,HÔPITAL DU CENTRE-DE-LA-MAURICIE,51220051,21072,3921,1465,7.9764869653,16400,2.8534346206,12959,1054,284,4.6953392537,8353,3.981972046,8113,1117,148,13.217506711,8047,1.681982761,2867,1181
2022-2023,8,04,Mauricie et Centre-du-Québec,CIUSSS DE LA MAURICIE-ET-DU-CENTRE-DU-QUÉBEC,HÔPITAL SAINTE-CROIX,51228781,26079,3468,1542,8.8219732991,19071,3.8768490116,16124,1060,415,6.4450850526,9428,5.1194043747,9955,1390,46,12.671792092,9643,2.6619976206,2408,1127
2022-2023,8,04,Mauricie et Centre-du-Québec,CIUSSS DE LA MAURICIE-ET-DU-CENTRE-DU-QUÉBEC,HÔTEL-DIEU D'ARTHABASKA,51228039,22367,3704,1307,6.5799986836,18098,2.1504833254,13406,1155,280,3.6553130232,9278,2.7293133697,8961,995,59,10.955440706,8820,1.5415961199,2549,1027
2022-2023,8,04,Mauricie et Centre-du-Québec,CIUSSS DE LA MAURICIE-ET-DU-CENTRE-DU-QUÉBEC,PAVILLON SAINTE-MARIE,51220168,36686,7862,2186,11.025022185,27180,3.5542674352,20372,1718,595,5.6490573936,11067,5.3380926026,16314,4311,771,17.738222794,16113,2.3290708158,6144,1591
2022-2023,8,05,Estrie,CIUSSS DE L'ESTRIE - CENTRE HOSPITALIER UNIVERSITAIRE DE SHERBROOKE,CENTRE DE SANTÉ ET DE SERVICES SOCIAUX DU GRANIT,51223832,9404,1488,279,6.5603264273,7676,3.5307249146,7541,878,156,5.0056050995,5833,3.9310820142,1863,246,34,12.853484523,1843,2.2636153313,610,123
2022-2023,8,05,Estrie,CIUSSS DE L'ESTRIE - CENTRE HOSPITALIER UNIVERSITAIRE DE SHERBROOKE,CENTRE MULTISERVICES DE SANTÉ ET DE SERVICES SOCIAUX DE LA MRC DE COATICOOK,51247617,11202,795,293,2.7124434625,9385,1.8715664772,8872,433,219,2.5168468528,7091,2.0031187812,2330,0,0,3.4572216261,2294,1.4649241984,362,74
2022-2023,8,05,Estrie,CIUSSS DE L'ESTRIE - CENTRE HOSPITALIER UNIVERSITAIRE DE SHERBROOKE,CENTRE MULTISERVICES DE SANTÉ ET DE SERVICES SOCIAUX DE MEMPHRÉMAGOG,51219046,14396,2781,503,6.918241564,12032,2.7262849993,10599,1258,278,3.9531748278,8293,3.0386351608,3797,695,289,15.194971176,3739,2.0335008618,1523,225
2022-2023,8,05,Estrie,CIUSSS DE L'ESTRIE - CENTRE HOSPITALIER UNIVERSITAIRE DE SHERBROOKE,CENTRE MULTISERVICES DE SANTÉ ET DE SERVICES SOCIAUX DES SOURCES,51247583,11406,1187,349,6.0407260068,8831,4.2107743869,10123,758,272,5.3918603949,7567,4.4835548728,1283,100,12,11.160341431,1264,2.5777601969,429,77
2022-2023,8,05,Estrie,CIUSSS DE L'ESTRIE - CENTRE HOSPITALIER UNIVERSITAIRE DE SHERBROOKE,CHUS - HÔPITAL FLEURIMONT,51216687,29749,3824,625,8.8023059599,24779,2.9423429786,16198,730,254,5.9976766679,11232,4.8480754392,13551,1848,140,12.154780705,13547,1.3622745503,3094,371
2022-2023,8,05,Estrie,CIUSSS DE L'ESTRIE - CENTRE HOSPITALIER UNIVERSITAIRE DE SHERBROOKE,CHUS - HÔTEL-DIEU DE SHERBROOKE,51216695,30107,5574,3759,10.598779907,24969,2.8009131323,14693,1181,693,5.3691145443,9586,4.4683322901,15414,3237,765,15.583824229,15383,1.7618518278,4393,3066
2022-2023,8,05,Estrie,CIUSSS DE L'ESTRIE - CENTRE HOSPITALIER UNIVERSITAIRE DE SHERBROOKE,HÔPITAL BROME-MISSISQUOI-PERKINS,51229185,17629,2648,568,9.7266104304,13679,3.8707125074,12706,962,239,5.4367630341,8817,4.4407711429,4923,1416,552,20.798477385,4862,2.8369389597,1686,329
2022-2023,8,05,Estrie,CIUSSS DE L'ESTRIE - CENTRE HOSPITALIER UNIVERSITAIRE DE SHERBROOKE,HÔPITAL DE GRANBY,51228120,24023,3900,1389,11.108487699,18006,4.6362041357,16335,1350,522,6.9887797844,10380,6.0027927103,7688,2515,551,19.861795294,7626,2.7760953755,2550,867
2022-2023,8,06,Montréal,CENTRE HOSPITALIER DE L'UNIVERSITÉ DE MONTRÉAL,CENTRE HOSPITALIER DE L'UNIVERSITÉ DE MONTRÉAL,51236297,41436,5730,3326,13.925633608,31876,3.1184813374,25234,1594,1236,7.4434561945,15805,4.8737524166,16202,6546,1855,24.021378876,16071,1.3922627196,4136,2090
2022-2023,8,06,Montréal,CENTRE HOSPITALIER UNIVERSITAIRE SAINTE-JUSTINE,CHU SAINTE-JUSTINE,51222800,57639,0,1155,6.2530935458,45380,2.9682232567,39291,0,576,5.6645364644,27979,3.6772012541,18348,357,5,7.5134486956,17401,1.8282603011,0,579
2022-2023,8,06,Montréal,CENTRE UNIVERSITAIRE DE SANTÉ MCGILL,HÔPITAL DE LACHINE,51228310,11945,1222,256,7.1413284266,10702,2.9595976349,9932,585,145,4.3029090873,8705,3.0503109643,2013,576,212,21.14588922,1997,2.5641747343,637,111
2022-2023,8,06,Montréal,CENTRE UNIVERSITAIRE DE SANTÉ MCGILL,HÔPITAL GÉNÉRAL DE MONTRÉAL,51248219,19484,3168,2318,16.844529771,16570,1.8960401328,8240,619,474,5.9961883765,5439,2.8459479377,11244,3482,1764,24.794577182,11131,1.4318816069,2549,1844
2022-2023,8,06,Montréal,CENTRE UNIVERSITAIRE DE SANTÉ MCGILL,HÔPITAL ROYAL VICTORIA,51223295,29064,4484,749,16.72600704,21989,4.3851700219,18984,1348,352,8.6940095022,12080,5.6271745769,10080,4408,2192,31.852935736,9909,2.8710500275,3136,397
2022-2023,8,06,Montréal,CENTRE UNIVERSITAIRE DE SANTÉ MCGILL,L'HÔPITAL DE MONTRÉAL POUR ENFANTS,51223279,49782,2,1450,7.6196980502,39882,2.8499429567,38449,0,442,7.0428680055,28643,3.5077249338,11333,602,36,9.5766854662,11239,1.1735616801,2,1008
2022-2023,8,06,Montréal,CIUSSS DE L'EST-DE-L'ÎLE-DE-MONTRÉAL,HÔPITAL MAISONNEUVE-ROSEMONT,12934659,41273,7407,3040,13.203716036,29827,3.4962554714,24672,1816,725,5.7944426768,13484,4.8388198359,16601,5993,2479,24.215196809,16343,2.3885556677,5591,2315
2022-2023,8,06,Montréal,CIUSSS DE L'EST-DE-L'ÎLE-DE-MONTRÉAL,HÔPITAL SANTA CABRINI,51235919,21803,5490,732,13.649043964,16966,3.0160826555,13328,1420,297,5.1270815618,8526,4.1884891313,8475,3201,1527,27.05089823,8440,1.8317298578,4070,435
2022-2023,8,06,Montréal,CIUSSS DE L'EST-DE-L'ÎLE-DE-MONTRÉAL,INSTITUT UNIVERSITAIRE EN SANTÉ MENTALE DE MONTRÉAL,51235307,2851,117,2842,18.380192135,2728,1.5637605898,1173,32,1164,3.6220765843,1050,1.7688015873,1678,884,303,28.69680092,1678,1.4354572242,85,1678
2022-2023,8,06,Montréal,CIUSSS DE L'OUEST-DE-L'ÎLE-DE-MONTRÉAL,CENTRE HOSPITALIER DE ST. MARY,51248243,21285,3955,1500,10.452496333,19633,2.4391517258,14350,1245,538,5.6586741192,12709,2.9296034962,6935,2154,446,20.371941,6924,1.538927643,2710,962
2022-2023,8,06,Montréal,CIUSSS DE L'OUEST-DE-L'ÎLE-DE-MONTRÉAL,HÔPITAL DE LASALLE,51224392,16327,2534,517,9.8065657262,12739,3.2376907964,12355,974,172,5.5360757003,8818,3.8037855019,3972,1268,524,23.090026015,3921,1.9645913032,1560,345
2022-2023,8,06,Montréal,CIUSSS DE L'OUEST-DE-L'ÎLE-DE-MONTRÉAL,HÔPITAL DOUGLAS,51235190,3303,64,3151,8.9975388536,2988,1.9311523873,1839,28,1693,3.4519100054,1526,1.9260830785,1464,293,48,15.963666894,1462,1.9364436085,36,1458
2022-2023,8,06,Montréal,CIUSSS DE L'OUEST-DE-L'ÎLE-DE-MONTRÉAL,HÔPITAL GÉNÉRAL DU LAKESHORE,51228278,23751,5058,1863,14.790014631,19191,2.7164810328,15334,1505,301,7.0015930467,10797,3.5051414745,8417,3294,1649,28.978877239,8394,1.7020461044,3553,1562
2022-2023,8,06,Montréal,CIUSSS DU CENTRE-OUEST-DE-L'ÎLE-DE-MONTRÉAL,HÔPITAL GÉNÉRAL JUIF,51248250,54431,10095,2902,10.099069985,47522,2.3350205753,21457,1405,345,4.1639431706,15433,2.8113729058,32974,4996,1198,13.961204274,32089,2.1059219584,8690,2557
2022-2023,8,06,Montréal,CIUSSS DU CENTRE-SUD-DE-L'ÎLE-DE-MONTRÉAL,HÔPITAL DE VERDUN,51218097,25803,4038,1757,8.5124095712,22822,2.0850340558,17460,1209,696,4.1455381348,14505,2.5955966333,8343,2282,231,17.651277518,8317,1.1946035897,2829,1061
2022-2023,8,06,Montréal,CIUSSS DU CENTRE-SUD-DE-L'ÎLE-DE-MONTRÉAL,HÔPITAL NOTRE-DAME,51236313,22662,2875,3271,13.29114211,19309,2.3733507259,13916,606,1161,5.7771328367,10593,3.2855041852,8746,3390,1175,25.246887942,8716,1.2647640355,2269,2110
2022-2023,8,06,Montréal,CIUSSS DU NORD-DE-L'ÎLE-DE-MONTRÉAL,HÔPITAL DU SACRÉ-COEUR-DE-MONTRÉAL,12475976,39280,7234,1971,12.572163873,31345,3.1481625813,26885,2369,947,6.7702249292,18992,4.3090792907,12395,5236,1952,25.156684124,12353,1.3633224498,4865,1024
2022-2023,8,06,Montréal,CIUSSS DU NORD-DE-L'ÎLE-DE-MONTRÉAL,HÔPITAL EN SANTÉ MENTALE ALBERT-PRÉVOST,51848752,2173,102,2165,20.809390883,2149,0.3342394395,973,28,965,3.7549240608,949,0.4635824259,1200,766,286,34.637721065,1200,0.2319506944,74,1200
2022-2023,8,06,Montréal,CIUSSS DU NORD-DE-L'ÎLE-DE-MONTRÉAL,HÔPITAL FLEURY,51228492,19692,3135,668,9.7340603629,14373,3.6368461892,14727,1233,333,5.7829785428,9431,4.5166082011,4965,1878,251,21.453613629,4942,1.9579640496,1902,335
2022-2023,8,06,Montréal,CIUSSS DU NORD-DE-L'ÎLE-DE-MONTRÉAL,HÔPITAL JEAN-TALON,51228500,25252,3146,1939,8.1746405675,18826,3.5705302655,18749,898,786,5.4574989185,12351,4.6127752814,6503,1569,83,16.008515514,6475,1.582457958,2248,1153
2022-2023,8,06,Montréal,INSTITUT DE CARDIOLOGIE DE MONTRÉAL,INSTITUT DE CARDIOLOGIE DE MONTRÉAL,51248201,11200,3135,338,9.3611410218,10899,1.2444884852,6830,1258,283,3.6351002115,6536,1.4552875952,4370,1237,155,18.310536613,4363,0.9287004991,1877,55
2022-2023,8,07,Outaouais,CISSS DE L'OUTAOUAIS,CENTRE MULTISERVICES DE SANTÉ ET DE SERVICES SOCIAUX DE MANSFIELD-ET-PONTEFRACT,51245058,6615,681,160,3.9781161502,6211,1.4870749924,6449,639,155,3.8597031409,6046,1.4922700959,166,3,0,8.5783902276,165,1.2967138047,42,5
2022-2023,8,07,Outaouais,CISSS DE L'OUTAOUAIS,CLSC ET CENTRE D'HÉBERGEMENT DE LA PETITE-NATION,51219491,7180,877,239,2.9750571418,5881,1.4445206786,6702,718,221,2.8346913028,5404,1.5057279587,478,0,0,4.9431154114,477,0.7510948055,159,18
2022-2023,8,07,Outaouais,CISSS DE L'OUTAOUAIS,HÔPITAL DE GATINEAU,51221703,23451,2928,2766,11.715135886,14965,3.8116474552,15297,1111,758,5.2761258017,6995,4.3776130569,8154,2569,1207,23.794794613,7970,3.3149185487,1817,2008
2022-2023,8,07,Outaouais,CISSS DE L'OUTAOUAIS,HÔPITAL DE HULL,51221711,20789,3438,767,12.251612672,13917,3.216886342,13949,1083,503,4.9746245848,7190,3.7417742621,6840,2320,1296,27.091774488,6727,2.655871901,2355,264
2022-2023,8,07,Outaouais,CISSS DE L'OUTAOUAIS,HÔPITAL DE MANIWAKI,51221893,8682,1141,441,6.2989251069,7560,2.6062903072,5787,510,225,3.7791412745,4776,2.7336686907,2895,345,125,11.335881597,2784,2.3877704941,631,216
2022-2023,8,07,Outaouais,CISSS DE L'OUTAOUAIS,HÔPITAL ET CHSLD DE PAPINEAU,51228823,13785,1642,605,8.9672110587,9778,3.3555449592,10546,697,258,3.7944772109,6572,3.5631957125,3239,1132,594,25.809338616,3206,2.9298803459,945,347
2022-2023,8,07,Outaouais,CISSS DE L'OUTAOUAIS,HÔPITAL ET CHSLD DU PONTIAC,51219459,6741,712,198,5.4189071849,6109,2.1337096452,5363,450,135,4.1094560984,4741,2.1598320795,1378,133,47,10.515123569,1368,2.0431786062,262,63
2022-2023,8,07,Outaouais,CISSS DE L'OUTAOUAIS,HÔPITAL ET CHSLD MÉMORIAL DE WAKEFIELD / WAKEFIELD MEMORIAL HOSPITAL,51228799,10258,717,266,5.4583342811,8264,3.0416542299,8954,494,194,4.357953925,6995,3.1138324597,1304,204,34,13.01416688,1269,2.6437923562,223,72
2022-2023,8,08,Abitibi-Témiscamingue,CISSS DE L'ABITIBI-TÉMISCAMINGUE,CENTRE MULTISERVICES DE SANTÉ ET DE SERVICES SOCIAUX DE LA SARRE,51247559,11343,1394,510,5.8781952893,10089,2.456098391,9560,855,399,4.5160395746,8326,2.6011366002,1783,218,97,13.181733502,1763,1.7711363207,539,111
2022-2023,8,08,Abitibi-Témiscamingue,CISSS DE L'ABITIBI-TÉMISCAMINGUE,CENTRE MULTISERVICES DE SANTÉ ET DE SERVICES SOCIAUX DE TÉMISCAMING-KIPAWA,51247476,2922,227,176,2.591766294,2817,0.8608297835,2892,217,171,2.5020717112,2788,0.8616073848,30,2,0,11.238324074,29,0.7860727969,10,5
2022-2023,8,08,Abitibi-Témiscamingue,CISSS DE L'ABITIBI-TÉMISCAMINGUE,CENTRE MULTISERVICES DE SANTÉ ET DE SERVICES SOCIAUX DE VILLE-MARIE,51247542,7299,936,444,5.3301539404,6283,2.9810989531,6326,615,338,4.6500557224,5331,3.0804870881,973,49,2,9.7518408131,952,2.4245462768,321,106
2022-2023,8,08,Abitibi-Témiscamingue,CISSS DE L'ABITIBI-TÉMISCAMINGUE,HÔPITAL D'AMOS,51228906,13791,1342,554,4.5338292485,12354,1.5798000648,10672,565,418,2.8150053098,9263,1.746913467,3119,309,46,10.414973549,3091,1.0790005033,777,136
2022-2023,8,08,Abitibi-Témiscamingue,CISSS DE L'ABITIBI-TÉMISCAMINGUE,HÔPITAL DE ROUYN-NORANDA,51228922,17085,1941,960,6.7709732546,12812,3.7091072172,14008,974,613,5.6359552478,9770,4.1782353292,3077,327,19,11.938127054,3042,2.2024071335,967,347
2022-2023,8,08,Abitibi-Témiscamingue,CISSS DE L'ABITIBI-TÉMISCAMINGUE,HÔPITAL DE VAL-D'OR,51225589,17166,1775,1157,7.4034798924,13512,4.1682680416,14039,935,824,5.7868244019,10392,4.7958492644,3127,613,60,14.661627136,3120,2.0779398148,840,333
2022-2023,8,09,Côte-Nord,CISSS DE LA CÔTE-NORD,CENTRE MULTISERVICES DE SANTÉ ET DE SERVICES SOCIAUX DE FERMONT,51245108,3971,26,200,9.2827466493,3225,2.0344809647,3789,24,192,9.4420566112,3043,2.0748174316,182,2,1,5.9661233211,182,1.3600641026,2,8
2022-2023,8,09,Côte-Nord,CISSS DE LA CÔTE-NORD,CENTRE MULTISERVICES DE SANTÉ ET DE SERVICES SOCIAUX DE FORESTVILLE,51218741,6932,989,287,3.1416840178,5783,1.8657509559,6256,781,243,2.7732052341,5169,1.9548223383,676,20,0,6.5517480276,614,1.1158975751,208,44
2022-2023,8,09,Côte-Nord,CISSS DE LA CÔTE-NORD,CENTRE MULTISERVICES DE SANTÉ ET DE SERVICES SOCIAUX DE LA BASSE-CÔTE-NORD,51245140,2202,297,103,3.3354372288,2109,1.2687852326,1790,208,89,3.1294168218,1700,1.3006263072,412,0,0,4.23052589,409,1.1364384678,89,14
2022-2023,8,09,Côte-Nord,CISSS DE LA CÔTE-NORD,CENTRE MULTISERVICES DE SANTÉ ET DE SERVICES SOCIAUX DE LA MINGANIE,51245116,7859,734,236,3.1107910605,4492,2.5131971035,5406,465,105,1.905549184,2138,2.6434740412,2453,50,3,5.7669417267,2354,2.3948742094,269,131
2022-2023,8,09,Côte-Nord,CISSS DE LA CÔTE-NORD,CENTRE MULTISERVICES DE SANTÉ ET DE SERVICES SOCIAUX DE PORT-CARTIER,51245132,8707,620,371,5.1468745773,7192,2.8256945603,7880,462,302,4.1684576283,6383,3.0077842185,827,134,35,14.469638251,809,1.389009408,158,69
2022-2023,8,09,Côte-Nord,CISSS DE LA CÔTE-NORD,CENTRE MULTISERVICES DE SANTÉ ET DE SERVICES SOCIAUX DES ESCOUMINS,51218733,6249,890,204,3.6384867801,5506,1.599844614,5514,604,176,3.0498327993,4781,1.6813276511,735,24,1,8.0545929705,725,1.0625061303,286,28
2022-2023,8,09,Côte-Nord,CISSS DE LA CÔTE-NORD,CLSC ET HÔPITAL LE ROYER,51228765,13704,2019,934,9.0945235779,11720,3.4639849261,10189,857,561,5.2938704594,8210,3.9881471106,3515,946,411,20.11155192,3510,2.2379531497,1162,373
2022-2023,8,09,Côte-Nord,CISSS DE LA CÔTE-NORD,HÔPITAL ET CLSC DE SEPT-ÎLES,51232023,13237,1345,804,9.2876374934,9986,3.9822327926,9174,497,365,5.2005709372,6032,4.3446135426,4063,938,345,18.515978273,3954,3.4294051031,848,439
2022-2023,8,11,Gaspésie-Îles-de-la-Madeleine,CISSS DE LA GASPÉSIE,CENTRE MULTISERVICES DE SANTÉ ET DE SERVICES SOCIAUX DE GRANDE-VALLÉE,51247732,3868,688,79,1.830432394,3097,0.8346667922,3505,547,69,1.4279607703,2774,0.8544164063,363,14,4,5.7165564738,323,0.6650524596,141,10
2022-2023,8,11,Gaspésie-Îles-de-la-Madeleine,CISSS DE LA GASPÉSIE,CLSC ET CENTRE DE SERVICES AMBULATOIRES DE MURDOCHVILLE,51221307,1217,129,59,2.845450105,1181,1.227307837,1187,121,59,2.7420043527,1151,1.2435534318,30,2,0,6.9384537037,30,0.6040185185,8,0
2022-2023,8,11,Gaspésie-Îles-de-la-Madeleine,CISSS DE LA GASPÉSIE,CLSC ET CENTRE DE SERVICES AMBULATOIRES DE PASPÉBIAC,51220978,8539,1438,306,4.0402050071,7649,1.9421016545,6654,891,246,3.2545052683,5862,2.0650282422,1885,75,12,6.813704244,1787,1.5388584219,547,60
2022-2023,8,11,Gaspésie-Îles-de-la-Madeleine,CISSS DE LA GASPÉSIE,HÔPITAL DE CHANDLER,51227775,10001,1583,394,5.8735308969,8586,2.2343685457,8468,1024,315,4.2000941781,7058,2.4257615472,1533,278,42,15.117276582,1528,1.3503032286,559,79
2022-2023,8,11,Gaspésie-Îles-de-la-Madeleine,CISSS DE LA GASPÉSIE,HÔPITAL DE GASPÉ,51220903,8945,1446,393,5.0031438731,7743,1.6991805502,7221,846,249,3.5859996307,6043,1.9259875981,1724,149,6,10.938873904,1700,0.8929482026,600,144
2022-2023,8,11,Gaspésie-Îles-de-la-Madeleine,CISSS DE LA GASPÉSIE,HÔPITAL ET CLSC DE SAINTE-ANNE-DES-MONTS,51247799,8557,1477,391,5.5748927454,7377,2.1686317835,6782,834,266,3.2568280006,5642,2.2665439757,1775,312,117,14.431858998,1735,1.8502337496,643,125
2022-2023,8,11,Gaspésie-Îles-de-la-Madeleine,CISSS DE LA GASPÉSIE,HÔPITAL ET GROUPE DE MÉDECINE DE FAMILLE UNIVERSITAIRE DE MARIA,51227908,10246,1772,541,8.9434824701,9447,2.136859438,7662,881,283,4.0624841208,6876,2.3536753442,2584,872,412,23.416473706,2571,1.5569970612,891,258
2022-2023,8,11,Gaspésie-Îles-de-la-Madeleine,CISSS DES ÎLES,HÔPITAL DE L'ARCHIPEL,51227783,11182,1347,298,4.6071556718,9758,2.039500353,9497,919,183,3.4791974951,8086,2.1734357738,1685,166,13,10.964555556,1672,1.3917719963,428,115
2022-2023,8,12,Chaudière-Appalaches,CISSS DE CHAUDIÈRE-APPALACHES,CHSLD ET HÔPITAL PAUL-GILBERT,51245199,28931,2051,427,2.5810743186,21559,1.9757021945,27606,1928,411,2.5368372013,20234,2.056558131,1325,0,0,3.5027421384,1325,0.7409557652,123,16
2022-2023,8,12,Chaudière-Appalaches,CISSS DE CHAUDIÈRE-APPALACHES,HÔPITAL DE MONTMAGNY,51245223,21199,3238,671,4.5432972336,19352,1.5067069008,16595,1587,354,2.5126983194,14750,1.7313112618,4604,521,25,11.862538976,4602,0.7868211285,1651,317
2022-2023,8,12,Chaudière-Appalaches,CISSS DE CHAUDIÈRE-APPALACHES,HÔPITAL DE SAINT-GEORGES,51228971,27136,4710,1339,7.1272082699,21978,2.5180661722,19019,1720,639,4.153730334,13889,3.1628475972,8117,1467,108,14.094385412,8089,1.4109615596,2990,700
2022-2023,8,12,Chaudière-Appalaches,CISSS DE CHAUDIÈRE-APPALACHES,HÔPITAL DE THETFORD,51245231,24022,3699,724,6.8049168355,21762,1.7000859041,19084,1924,382,4.5792836931,16829,1.9107745723,4938,1065,169,15.40637145,4933,0.9813185013,1775,342
2022-2023,8,12,Chaudière-Appalaches,CISSS DE CHAUDIÈRE-APPALACHES,HÔTEL-DIEU DE LÉVIS,51227569,47946,8754,3068,7.9766402886,42969,1.3475956697,33552,3300,1506,3.2499118118,28579,1.6957170572,14394,4259,1011,18.994508418,14390,0.656215466,5454,1562
2022-2023,8,13,Laval,CISSS DE LAVAL,HÔPITAL DE LA CITÉ-DE-LA-SANTÉ,51228757,58252,9691,3561,9.2484344982,43196,3.2414033257,39028,2839,1061,5.5442282393,24043,4.1745212282,19224,4343,343,16.768605216,19153,2.0700487739,6852,2500
2022-2023,8,14,Lanaudière,CISSS DE LANAUDIÈRE,HÔPITAL DE LANAUDIÈRE ET CENTRE D'HÉBERGEMENT PARPHILIA-FERLAND,51244945,42472,6865,2710,10.162587973,34397,2.5711899697,28175,2012,1922,5.6396164646,20181,3.389488972,14297,4111,1313,19.075976953,14216,1.4095346402,4853,788
2022-2023,8,14,Lanaudière,CISSS DE LANAUDIÈRE,HÔPITAL PIERRE-LE GARDEUR,51228062,47666,7834,2667,11.268196117,29008,5.6078125383,33026,2723,982,6.8898410427,14426,7.2827641835,14640,5356,854,21.145214879,14582,3.9507797284,5111,1685
2022-2023,8,15,Laurentides,CISSS DES LAURENTIDES,CENTRE MULTISERVICES DE SANTÉ ET DE SERVICES SOCIAUX D'ARGENTEUIL,51245306,12726,1618,423,9.7293776521,9990,3.8372812535,10505,907,274,6.083415014,7781,4.371676127,2221,928,416,26.974239207,2209,1.9549242996,711,149
2022-2023,8,15,Laurentides,CISSS DES LAURENTIDES,CENTRE MULTISERVICES DE SANTÉ ET DE SERVICES SOCIAUX DE RIVIÈRE-ROUGE,51217628,9171,962,436,6.2215738015,7881,2.8897537326,7401,556,227,3.9769891081,6137,3.0533244166,1770,331,111,15.606981325,1744,2.3141612513,406,209
2022-2023,8,15,Laurentides,CISSS DES LAURENTIDES,CENTRE MULTISERVICES DE SANTÉ ET DE SERVICES SOCIAUX DE SAINTE-AGATHE,51246874,19000,3384,1026,12.508080702,14915,4.1704974485,12645,1299,311,6.9245641887,8618,5.2740821536,6355,2274,772,23.61800459,6297,2.660144425,2085,715
2022-2023,8,15,Laurentides,CISSS DES LAURENTIDES,HÔPITAL DE MONT-LAURIER,51217610,10630,1461,558,9.5509234609,8543,3.0688658356,8159,714,296,5.7717650584,6109,3.3163683363,2471,759,299,22.02933439,2434,2.4476691317,747,262
2022-2023,8,15,Laurentides,CISSS DES LAURENTIDES,HÔPITAL DE SAINT-EUSTACHE,51228864,30829,5505,1674,12.908252196,21413,3.6409852919,19172,1516,498,6.6837213413,9818,5.3610016183,11657,4406,1525,23.145595041,11595,2.1845712951,3989,1176
2022-2023,8,15,Laurentides,CISSS DES LAURENTIDES,HÔPITAL DE SAINT-JÉRÔME,51228880,35740,5966,3441,15.019479816,24197,4.9499593154,21205,1799,994,7.2064900181,9774,6.8991472842,14535,5615,2244,26.417790697,14423,3.629057755,4167,2447
2022-2023,8,16,Montérégie,CISSS DE LA MONTÉRÉGIE-CENTRE,HÔPITAL CHARLES-LE MOYNE,51233799,48500,7889,3798,9.9925315178,26038,5.3940233398,34706,3012,1609,6.173505918,12254,6.520624762,13794,4419,453,19.601281878,13784,4.3924727139,4877,2189
2022-2023,8,16,Montérégie,CISSS DE LA MONTÉRÉGIE-CENTRE,HÔPITAL DU HAUT-RICHELIEU,51229045,38943,5589,2225,10.195373152,28404,3.0308632196,28215,2088,831,5.0240591588,17751,3.6377076565,10728,3248,1912,23.796102489,10653,2.0196836833,3501,1394
2022-2023,8,16,Montérégie,CISSS DE LA MONTÉRÉGIE-EST,HÔPITAL HONORÉ-MERCIER,51229193,28668,5302,1697,11.027738535,20689,4.4670944973,20913,2183,857,6.1902174086,12949,5.6558216636,7755,2877,1180,24.073138835,7740,2.4783570198,3119,840
2022-2023,8,16,Montérégie,CISSS DE LA MONTÉRÉGIE-EST,HÔPITAL PIERRE-BOUCHER,51229011,34526,6590,2143,13.846456334,24977,4.7365532401,17534,1925,655,6.2504247304,8181,6.1806192193,16992,4899,2134,21.684781319,16796,4.0331772115,4665,1488
2022-2023,8,16,Montérégie,CISSS DE LA MONTÉRÉGIE-EST,HÔTEL-DIEU DE SOREL,51229102,21380,3286,1040,9.0725567768,18186,2.4647018616,14710,1326,323,4.8962295113,11564,2.9751234675,6670,1780,559,18.283017658,6622,1.5733525034,1960,717
2022-2023,8,16,Montérégie,CISSS DE LA MONTÉRÉGIE-OUEST,HÔPITAL ANNA-LABERGE,51229151,23469,4551,1258,17.744167625,17154,2.2038625588,15526,1432,354,8.3842492164,9213,3.1169959116,7943,4089,2142,36.039785555,7941,1.1444622843,3119,904
2022-2023,8,16,Montérégie,CISSS DE LA MONTÉRÉGIE-OUEST,HÔPITAL BARRIE MEMORIAL / BARRIE MEMORIAL HOSPITAL,51228005,13737,1323,217,5.857549562,10821,3.3372019684,11674,763,168,4.1938373261,8772,3.0344752242,2063,431,40,15.272080169,2049,4.6332092891,560,49
2022-2023,8,16,Montérégie,CISSS DE LA MONTÉRÉGIE-OUEST,HÔPITAL DU SUROÎT,51229136,23317,4382,1684,13.96973983,18385,2.2465128124,15499,1327,993,4.5159355263,10601,2.9555174826,7818,3119,1816,32.711683153,7784,1.2809220481,3055,691
2023-2024,8,01,Bas-Saint-Laurent,CISSS DU BAS-SAINT-LAURENT,CENTRE HOSPITALIER RÉGIONAL DU GRAND-PORTAGE,51218352,12728,2383,681,5.0634734444,10813,2.1939245969,9242,1046,376,3.4604270661,7348,2.4549317275,3486,50,1,9.3134317428,3465,1.6404237614,1337,305
2023-2024,8,01,Bas-Saint-Laurent,CISSS DU BAS-SAINT-LAURENT,CENTRE MULTISERVICES DE SANTÉ ET DE SERVICES SOCIAUX DE TROIS-PISTOLES,51236156,6868,1106,186,3.3800810118,6250,1.4156500444,5795,721,132,2.5128422011,5201,1.5186224337,1073,32,1,8.0638171792,1049,0.905107245,385,54
2023-2024,8,01,Bas-Saint-Laurent,CISSS DU BAS-SAINT-LAURENT,CLSC DE POHÉNÉGAMOOK,51219418,6434,885,202,1.8473216074,5978,0.9042105777,6017,762,188,1.5275695252,5562,0.9145561149,417,3,0,6.4611064482,416,0.7658887553,123,14
2023-2024,8,01,Bas-Saint-Laurent,CISSS DU BAS-SAINT-LAURENT,HÔPITAL D'AMQUI,51226892,9268,1511,311,4.4142067688,8115,1.8450144451,5249,541,168,3.5091398362,4268,2.1398063105,4019,58,3,5.5962660695,3847,1.5179617595,970,143
2023-2024,8,01,Bas-Saint-Laurent,CISSS DU BAS-SAINT-LAURENT,HÔPITAL DE MATANE,51218980,10432,1828,415,5.4256950302,9115,2.7604703785,7638,870,235,4.6531788426,6393,3.1574638493,2794,86,6,7.5375342003,2722,1.8280753531,958,180
2023-2024,8,01,Bas-Saint-Laurent,CISSS DU BAS-SAINT-LAURENT,HÔPITAL DE NOTRE-DAME-DU-LAC,51221877,7937,1474,229,3.4985951171,7101,1.4254732901,6305,866,127,2.3399229448,5488,1.5907588273,1632,41,0,7.9749603418,1613,0.8631130743,608,102
2023-2024,8,01,Bas-Saint-Laurent,CISSS DU BAS-SAINT-LAURENT,HÔPITAL NOTRE-DAME-DE-FATIMA,51221141,10145,1895,335,3.9252504244,9334,1.6583160429,7922,1011,168,2.8953165236,7128,1.8073350792,2223,15,1,7.595577173,2206,1.1768075703,884,167
2023-2024,8,01,Bas-Saint-Laurent,CISSS DU BAS-SAINT-LAURENT,HÔPITAL RÉGIONAL DE RIMOUSKI,51227882,18912,3528,1009,6.1702790263,15175,2.4681357862,13449,1463,568,4.1766238299,9760,2.8759805043,5463,506,50,11.078327486,5415,1.733036165,2065,441
2023-2024,8,02,Saguenay-Lac-Saint-Jean,CIUSSS DU SAGUENAY - LAC-SAINT-JEAN,HÔPITAL D'ALMA,51219400,21112,3226,808,4.7876463491,16756,2.7985451812,16129,1747,382,3.682907668,11874,3.0102538693,4983,78,0,8.3634701875,4882,2.2836273271,1479,426
2023-2024,8,02,Saguenay-Lac-Saint-Jean,CIUSSS DU SAGUENAY - LAC-SAINT-JEAN,HÔPITAL DE CHICOUTIMI,51218394,33195,5426,2253,7.3076132199,29187,2.4574206839,19063,1714,744,3.8568460864,15183,3.2354829414,14132,1810,131,11.962437298,14004,1.6138531848,3712,1509
2023-2024,8,02,Saguenay-Lac-Saint-Jean,CIUSSS DU SAGUENAY - LAC-SAINT-JEAN,HÔPITAL DE DOLBEAU-MISTASSINI,51219384,12634,2143,436,4.1899605782,11406,1.8239361593,10555,1398,236,2.9665574504,9349,1.9598347417,2079,142,24,10.401129416,2057,1.2062813969,745,200
2023-2024,8,02,Saguenay-Lac-Saint-Jean,CIUSSS DU SAGUENAY - LAC-SAINT-JEAN,HÔPITAL DE LA BAIE,51221364,11165,1511,384,5.2849419565,10139,2.6305804594,8627,711,236,4.0175726724,7622,2.9106694073,2538,80,0,9.5928989362,2517,1.7824128151,800,148
2023-2024,8,02,Saguenay-Lac-Saint-Jean,CIUSSS DU SAGUENAY - LAC-SAINT-JEAN,HÔPITAL ET CENTRE D'HÉBERGEMENT DE ROBERVAL,51228203,14491,2132,963,5.5678586134,13104,2.1429937848,9823,900,325,3.3172503309,8528,2.3531858453,4668,410,38,10.303875143,4576,1.7512722174,1232,638
2023-2024,8,02,Saguenay-Lac-Saint-Jean,CIUSSS DU SAGUENAY - LAC-SAINT-JEAN,HÔPITAL ET CENTRE DE RÉADAPTATION DE JONQUIÈRE,51224541,16081,2973,837,7.5518457427,12715,4.1099104732,9735,1080,308,4.9617056725,6609,4.5280481162,6346,439,4,11.525216935,6106,3.6573274921,1893,529
2023-2024,8,03,Capitale-Nationale,CHU DE QUÉBEC - UNIVERSITÉ LAVAL,CENTRE HOSPITALIER DE L'UNIVERSITÉ LAVAL,51217594,44177,3854,4183,8.3303944297,35527,2.256163192,24649,757,1345,4.9571880311,16069,3.5208321233,19528,2145,753,12.58818655,19458,1.2117616576,3097,2838
2023-2024,8,03,Capitale-Nationale,CHU DE QUÉBEC - UNIVERSITÉ LAVAL,HÔPITAL DE L'ENFANT-JÉSUS,51233914,38497,6581,4749,10.093276713,34709,1.6524071967,21644,2257,1255,4.0889540853,17960,2.0692405964,16853,3888,1003,17.804518566,16749,1.205435565,4324,3494
2023-2024,8,03,Capitale-Nationale,CHU DE QUÉBEC - UNIVERSITÉ LAVAL,HÔPITAL DU SAINT-SACREMENT,51217529,21663,5066,592,7.7780703273,17954,1.9849802891,15244,2036,233,3.5548127314,11567,2.3372091823,6419,1741,341,17.807566945,6387,1.3470858776,3030,359
2023-2024,8,03,Capitale-Nationale,CHU DE QUÉBEC - UNIVERSITÉ LAVAL,HÔPITAL SAINT-FRANÇOIS D'ASSISE,51217602,26001,6485,841,10.130161981,21027,2.3332828031,15715,1908,410,4.6350126383,10769,3.1380914611,10286,3034,440,18.525677431,10258,1.4883827798,4577,431
2023-2024,8,03,Capitale-Nationale,CHU DE QUÉBEC - UNIVERSITÉ LAVAL,L'HÔTEL-DIEU DE QUÉBEC,51217586,13138,3046,620,7.4754125015,11860,1.5392612891,6814,695,207,3.2051283306,5595,1.7737838844,6324,688,11,12.076569418,6265,1.3298193225,2351,413
2023-2024,8,03,Capitale-Nationale,CIUSSS DE LA CAPITALE-NATIONALE,CENTRE MULTISERVICES DE SANTÉ ET DE SERVICES SOCIAUX CHAUVEAU,51225001,24668,1778,340,2.9440579338,16860,1.8980714215,21741,1439,260,2.7529321839,13988,2.0688166643,2927,0,0,4.3636906389,2872,1.0664612349,339,80
2023-2024,8,03,Capitale-Nationale,CIUSSS DE LA CAPITALE-NATIONALE,CENTRE MULTISERVICES DE SANTÉ ET DE SERVICES SOCIAUX DE BAIE-SAINT-PAUL,51244804,7585,1378,228,5.2469779536,5898,2.0154733243,6148,881,99,3.0518189294,4471,2.2148538731,1437,233,58,14.638653445,1427,1.3907848633,497,129
2023-2024,8,03,Capitale-Nationale,CIUSSS DE LA CAPITALE-NATIONALE,CENTRE MULTISERVICES DE SANTÉ ET DE SERVICES SOCIAUX DE SAINT-MARC-DES-CARRIÈRES,51247344,10427,1377,238,2.9844844314,8778,1.5210986747,8425,759,155,2.3133942631,6831,1.7325937719,2002,29,5,5.8086276224,1947,0.7790735034,618,83
2023-2024,8,03,Capitale-Nationale,CIUSSS DE LA CAPITALE-NATIONALE,CENTRE MULTISERVICES DE SANTÉ ET DE SERVICES SOCIAUX DE SAINT-RAYMOND,51247302,12350,1739,229,4.2767676113,10054,2.075221968,10027,986,142,3.3294294017,7758,2.3593750895,2323,87,8,8.3658594012,2296,1.1150913424,753,87
2023-2024,8,03,Capitale-Nationale,CIUSSS DE LA CAPITALE-NATIONALE,CENTRE MULTISERVICES DE SANTÉ ET DE SERVICES SOCIAUX DE SAINTE-ANNE-DE-BEAUPRÉ,51225357,9664,1114,132,4.1111390499,7366,2.0249078725,8266,669,90,3.2002349988,5991,2.2001162855,1398,84,10,9.4970710141,1375,1.2615088889,445,42
2023-2024,8,03,Capitale-Nationale,CIUSSS DE LA CAPITALE-NATIONALE,HÔPITAL ET CLSC DE LA MALBAIE,51228690,8567,1606,251,5.8732096352,7016,1.7626717899,6906,1031,139,3.2927487772,5357,2.0163339763,1661,329,99,16.602085424,1659,0.9435829817,575,112
2023-2024,8,03,Capitale-Nationale,INSTITUT UNIVERSITAIRE DE CARDIOLOGIE ET DE PNEUMOLOGIE DE QUÉBEC - UNIVERSITÉ LAVAL,INSTITUT UNIVERSITAIRE DE CARDIOLOGIE ET DE PNEUMOLOGIE DE QUÉBEC,51232130,17729,6019,446,8.0205039139,16685,2.0746349848,9261,2113,257,4.095005489,8239,2.662378626,8468,955,4,12.313612194,8446,1.5012961428,3906,189
2023-2024,8,04,Mauricie et Centre-du-Québec,CIUSSS DE LA MAURICIE-ET-DU-CENTRE-DU-QUÉBEC,CENTRE MULTISERVICES DE SANTÉ ET DE SERVICES SOCIAUX AVELLIN-DALCOURT,51233583,13251,1915,330,4.7466820114,10747,2.9044750215,11291,1116,188,3.9329297425,8810,3.2004827217,1960,91,13,9.4344763322,1937,1.5581519245,799,142
2023-2024,8,04,Mauricie et Centre-du-Québec,CIUSSS DE LA MAURICIE-ET-DU-CENTRE-DU-QUÉBEC,CENTRE MULTISERVICES DE SANTÉ ET DE SERVICES SOCIAUX CHRIST-ROI,51246338,13189,1415,387,5.0718416441,10574,3.2928364647,10863,662,277,4.0659735647,8307,3.5321942338,2326,143,25,9.7694963934,2267,2.4157544234,753,110
2023-2024,8,04,Mauricie et Centre-du-Québec,CIUSSS DE LA MAURICIE-ET-DU-CENTRE-DU-QUÉBEC,CENTRE MULTISERVICES DE SANTÉ ET DE SERVICES SOCIAUX DE FORTIERVILLE,51219160,7230,684,144,2.5185315814,5668,2.0831578844,6758,611,132,2.439202509,5201,2.1588265611,472,1,0,3.6543491055,467,1.2404324292,73,12
2023-2024,8,04,Mauricie et Centre-du-Québec,CIUSSS DE LA MAURICIE-ET-DU-CENTRE-DU-QUÉBEC,CENTRE MULTISERVICES DE SANTÉ ET DE SERVICES SOCIAUX DU HAUT-SAINT-MAURICE,51219731,7305,1149,367,6.016565138,6290,2.834478449,5409,644,176,4.06612282,4428,3.0810222824,1896,184,7,11.580880802,1862,2.2481754983,505,191
2023-2024,8,04,Mauricie et Centre-du-Québec,CIUSSS DE LA MAURICIE-ET-DU-CENTRE-DU-QUÉBEC,HÔPITAL DU CENTRE-DE-LA-MAURICIE,51220051,20994,4100,1381,7.6932512464,16727,3.0667526056,13126,1296,307,4.9929175767,8907,4.319427136,7868,856,59,12.198154621,7820,1.6399531117,2804,1074
2023-2024,8,04,Mauricie et Centre-du-Québec,CIUSSS DE LA MAURICIE-ET-DU-CENTRE-DU-QUÉBEC,HÔPITAL SAINTE-CROIX,51228781,24851,3864,1463,8.1806651532,18312,3.4629359618,14411,1078,358,5.5612169331,8241,4.5343258302,10440,1147,32,11.796457136,10071,2.5862281965,2786,1105
2023-2024,8,04,Mauricie et Centre-du-Québec,CIUSSS DE LA MAURICIE-ET-DU-CENTRE-DU-QUÉBEC,HÔTEL-DIEU D'ARTHABASKA,51228039,23239,4101,1237,5.9492373931,19315,2.2159380303,14096,1321,291,3.8747251978,10317,2.8116906562,9143,534,13,9.1475665962,8998,1.5328551406,2780,946
2023-2024,8,04,Mauricie et Centre-du-Québec,CIUSSS DE LA MAURICIE-ET-DU-CENTRE-DU-QUÉBEC,PAVILLON SAINTE-MARIE,51220168,35997,8205,2126,10.402081886,27517,3.2376206325,19466,1942,613,5.2621682963,11162,4.7741581059,16531,3921,509,16.454562556,16355,2.1889608173,6263,1513
2023-2024,8,05,Estrie,CIUSSS DE L'ESTRIE - CENTRE HOSPITALIER UNIVERSITAIRE DE SHERBROOKE,CENTRE DE SANTÉ ET DE SERVICES SOCIAUX DU GRANIT,51223832,9170,1459,261,5.7258910396,7683,3.2633915788,7475,859,162,4.5404009662,6002,3.5119742493,1695,131,3,10.953937234,1681,2.3758287065,600,99
2023-2024,8,05,Estrie,CIUSSS DE L'ESTRIE - CENTRE HOSPITALIER UNIVERSITAIRE DE SHERBROOKE,CENTRE MULTISERVICES DE SANTÉ ET DE SERVICES SOCIAUX DE LA MRC DE COATICOOK,51247617,12224,1065,325,2.8832138053,9760,2.0961532332,9637,689,237,2.6893196649,7214,2.2798405107,2587,0,0,3.6055013314,2546,1.5756818975,376,88
2023-2024,8,05,Estrie,CIUSSS DE L'ESTRIE - CENTRE HOSPITALIER UNIVERSITAIRE DE SHERBROOKE,CENTRE MULTISERVICES DE SANTÉ ET DE SERVICES SOCIAUX DE MEMPHRÉMAGOG,51219046,14972,2959,501,6.5436092743,12672,2.827187237,11152,1441,236,4.161034518,8904,3.1258348308,3820,607,182,13.499230657,3768,2.1214658528,1518,265
2023-2024,8,05,Estrie,CIUSSS DE L'ESTRIE - CENTRE HOSPITALIER UNIVERSITAIRE DE SHERBROOKE,CENTRE MULTISERVICES DE SANTÉ ET DE SERVICES SOCIAUX DES SOURCES,51247583,10787,1351,369,5.2547666687,8854,3.5952861858,9359,889,259,4.6181689342,7445,3.8631887546,1428,85,4,9.4269782913,1409,2.1797186736,462,110
2023-2024,8,05,Estrie,CIUSSS DE L'ESTRIE - CENTRE HOSPITALIER UNIVERSITAIRE DE SHERBROOKE,CHUS - HÔPITAL FLEURIMONT,51216687,28154,4186,663,9.1852341882,23717,2.9113708873,14598,827,251,6.3155432251,10167,5.0828546605,13556,1882,112,12.27550777,13550,1.2820369004,3359,412
2023-2024,8,05,Estrie,CIUSSS DE L'ESTRIE - CENTRE HOSPITALIER UNIVERSITAIRE DE SHERBROOKE,CHUS - HÔTEL-DIEU DE SHERBROOKE,51216695,28819,5808,3500,11.331605307,24279,2.9305057869,14518,1552,762,5.6977533636,9999,4.5077774444,14301,3337,965,17.05094399,14280,1.826084267,4256,2738
2023-2024,8,05,Estrie,CIUSSS DE L'ESTRIE - CENTRE HOSPITALIER UNIVERSITAIRE DE SHERBROOKE,HÔPITAL BROME-MISSISQUOI-PERKINS,51229185,16950,2752,555,9.5028367748,13577,3.9461406341,11917,990,223,5.5263442514,8605,4.5249042869,5033,1411,409,18.918267214,4972,2.9444790829,1762,332
2023-2024,8,05,Estrie,CIUSSS DE L'ESTRIE - CENTRE HOSPITALIER UNIVERSITAIRE DE SHERBROOKE,HÔPITAL DE GRANBY,51228120,22898,3892,1547,11.285861914,17876,4.6501957311,15493,1499,602,7.0996876367,10515,5.8828580599,7405,2473,520,20.044322155,7361,2.8893691603,2393,945
2023-2024,8,06,Montréal,CENTRE HOSPITALIER DE L'UNIVERSITÉ DE MONTRÉAL,CENTRE HOSPITALIER DE L'UNIVERSITÉ DE MONTRÉAL,51236297,44858,6641,3397,12.685034566,33660,3.1994875223,26329,1850,1012,7.5201118011,15276,5.26367941,18529,6010,998,20.024192182,18384,1.4842680229,4791,2385
2023-2024,8,06,Montréal,CENTRE HOSPITALIER UNIVERSITAIRE SAINTE-JUSTINE,CHU SAINTE-JUSTINE,51222800,47349,0,1092,5.1558165959,41275,1.9357292886,30040,0,464,4.3772348258,24463,2.4885113573,17309,247,3,6.5070556262,16812,1.1313807433,0,628
2023-2024,8,06,Montréal,CENTRE UNIVERSITAIRE DE SANTÉ MCGILL,HÔPITAL DE LACHINE,51228310,12432,980,209,6.4026725386,10525,3.818658881,10880,691,148,5.1924920854,8989,3.9617330132,1552,258,58,14.886411798,1536,2.9813585069,289,61
2023-2024,8,06,Montréal,CENTRE UNIVERSITAIRE DE SANTÉ MCGILL,HÔPITAL GÉNÉRAL DE MONTRÉAL,51248219,20114,2994,2599,17.016038663,17257,1.774178562,8460,604,568,6.0633188863,5704,2.6151743416,11654,3536,1708,24.966957602,11553,1.3589582792,2390,2031
2023-2024,8,06,Montréal,CENTRE UNIVERSITAIRE DE SANTÉ MCGILL,HÔPITAL ROYAL VICTORIA,51223295,28679,4771,727,17.073504016,21658,4.2743426345,17330,1345,296,8.6106616336,10571,5.6338688918,11349,4670,2230,29.996321751,11087,2.9780900805,3426,431
2023-2024,8,06,Montréal,CENTRE UNIVERSITAIRE DE SANTÉ MCGILL,L'HÔPITAL DE MONTRÉAL POUR ENFANTS,51223279,41733,5,1331,5.7515068012,39122,1.4734945243,32123,1,422,4.5615150273,29528,1.6720348295,9610,630,34,9.7292493352,9594,0.8624357237,4,909
2023-2024,8,06,Montréal,CIUSSS DE L'EST-DE-L'ÎLE-DE-MONTRÉAL,HÔPITAL MAISONNEUVE-ROSEMONT,12934659,39791,6947,2577,11.33757228,30482,3.1534590997,23707,1802,602,5.3431365091,14496,4.395101024,16084,5082,1240,20.173066488,15986,2.0275463426,5145,1975
2023-2024,8,06,Montréal,CIUSSS DE L'EST-DE-L'ÎLE-DE-MONTRÉAL,HÔPITAL SANTA CABRINI,51235919,21516,5294,762,13.655225569,16681,3.2250222309,12678,1423,285,6.3225134091,7877,4.6691917749,8838,3209,1242,24.173909067,8804,1.9329137008,3871,477
2023-2024,8,06,Montréal,CIUSSS DE L'EST-DE-L'ÎLE-DE-MONTRÉAL,INSTITUT UNIVERSITAIRE EN SANTÉ MENTALE DE MONTRÉAL,51235307,3075,135,3070,13.332313008,3011,1.5765743201,1472,51,1468,3.5607516229,1408,1.5533301768,1603,577,143,22.305325085,1603,1.5969908851,84,1602
2023-2024,8,06,Montréal,CIUSSS DE L'OUEST-DE-L'ÎLE-DE-MONTRÉAL,CENTRE HOSPITALIER DE ST. MARY,51248243,20330,4114,1510,11.566027914,18562,2.450193765,13358,1393,535,5.6040341618,11607,2.9506235461,6972,2467,693,22.988906937,6955,1.6150408579,2721,975
2023-2024,8,06,Montréal,CIUSSS DE L'OUEST-DE-L'ÎLE-DE-MONTRÉAL,HÔPITAL DE LASALLE,51224392,16298,2556,538,10.443589534,12777,3.5874028202,12343,1075,165,6.2669399885,8848,4.3087653205,3955,1323,515,23.478326661,3929,1.9629142982,1481,373
2023-2024,8,06,Montréal,CIUSSS DE L'OUEST-DE-L'ÎLE-DE-MONTRÉAL,HÔPITAL DOUGLAS,51235190,3532,83,3404,15.076414056,3251,2.1226285075,1883,37,1773,3.7857968962,1604,2.1363535605,1649,774,251,27.969217034,1647,2.1092617891,46,1631
2023-2024,8,06,Montréal,CIUSSS DE L'OUEST-DE-L'ÎLE-DE-MONTRÉAL,HÔPITAL GÉNÉRAL DU LAKESHORE,51228278,23268,5328,1690,15.116090709,19197,2.599264425,14528,1571,226,7.0419549032,10493,3.3208780722,8740,3518,1607,28.537262904,8704,1.7293319802,3757,1464
2023-2024,8,06,Montréal,CIUSSS DU CENTRE-OUEST-DE-L'ÎLE-DE-MONTRÉAL,HÔPITAL GÉNÉRAL JUIF,51248250,55353,10748,3060,11.063148464,47199,2.6222795798,20006,1372,339,4.1787408916,12939,3.1814985273,35347,5698,1555,14.959644854,34260,2.4110789388,9376,2721
2023-2024,8,06,Montréal,CIUSSS DU CENTRE-SUD-DE-L'ÎLE-DE-MONTRÉAL,HÔPITAL DE VERDUN,51218097,26277,4688,1640,9.3459468673,22779,2.2271970163,17311,1515,619,4.3643539914,13836,2.8163245639,8966,2941,283,18.964099251,8943,1.3157390324,3173,1021
2023-2024,8,06,Montréal,CIUSSS DU CENTRE-SUD-DE-L'ÎLE-DE-MONTRÉAL,HÔPITAL NOTRE-DAME,51236313,23432,3273,3542,13.235075846,19632,2.269859866,13721,735,1269,5.5769253739,9961,3.1870680376,9711,3660,1084,24.055535389,9671,1.3251477786,2538,2273
2023-2024,8,06,Montréal,CIUSSS DU NORD-DE-L'ÎLE-DE-MONTRÉAL,HÔPITAL DU SACRÉ-COEUR-DE-MONTRÉAL,12475976,39532,7646,1810,12.735579116,30794,3.2827140388,26942,2510,754,6.9699874937,18231,4.5771525911,12590,5442,2040,25.073670417,12563,1.4042686637,5136,1056
2023-2024,8,06,Montréal,CIUSSS DU NORD-DE-L'ÎLE-DE-MONTRÉAL,HÔPITAL EN SANTÉ MENTALE ALBERT-PRÉVOST,51848752,2060,67,2055,23.30923719,2031,0.347344904,906,24,901,4.1487294579,877,0.4572719498,1154,698,334,38.352062151,1154,0.2638041594,43,1154
2023-2024,8,06,Montréal,CIUSSS DU NORD-DE-L'ÎLE-DE-MONTRÉAL,HÔPITAL FLEURY,51228492,18634,3104,571,9.9251320764,13497,4.2551502186,13407,1142,248,6.3680257204,8287,5.4853195433,5227,1657,103,19.048936345,5210,2.2984490296,1962,323
2023-2024,8,06,Montréal,CIUSSS DU NORD-DE-L'ÎLE-DE-MONTRÉAL,HÔPITAL JEAN-TALON,51228500,25924,3301,2085,7.8025360455,19200,3.1337777778,19321,1164,770,5.0781083766,12628,3.9505098898,6603,1456,62,15.774468045,6572,1.5644392034,2137,1315
2023-2024,8,06,Montréal,INSTITUT DE CARDIOLOGIE DE MONTRÉAL,INSTITUT DE CARDIOLOGIE DE MONTRÉAL,51248201,11985,3349,317,8.7093696287,11603,1.4766548881,7513,1499,262,3.934443668,7135,1.7348037842,4472,1003,64,16.731287952,4468,1.0644139809,1850,55
2023-2024,8,07,Outaouais,CISSS DE L'OUTAOUAIS,CENTRE MULTISERVICES DE SANTÉ ET DE SERVICES SOCIAUX DE MANSFIELD-ET-PONTEFRACT,51245058,5756,632,151,4.1336668018,5385,1.7023345713,5471,590,140,4.0170098905,5100,1.7116916122,285,3,0,6.3730701754,285,1.5348927875,42,11
2023-2024,8,07,Outaouais,CISSS DE L'OUTAOUAIS,CLSC ET CENTRE D'HÉBERGEMENT DE LA PETITE-NATION,51219491,6478,848,227,2.900552168,5396,1.3737829462,5944,690,207,2.7363469231,4863,1.4534339799,534,4,0,4.7283348939,533,0.6470606629,158,20
2023-2024,8,07,Outaouais,CISSS DE L'OUTAOUAIS,HÔPITAL DE GATINEAU,51221703,23672,3073,2695,12.818114603,14683,5.2005965705,15288,1134,747,6.5489902029,6606,5.8920963266,8384,2891,1192,24.249695452,8077,4.6350341849,1939,1948
2023-2024,8,07,Outaouais,CISSS DE L'OUTAOUAIS,HÔPITAL DE HULL,51221711,21054,3966,638,14.073966137,13827,4.422619613,13754,1338,379,7.0796023783,6718,5.1943650971,7300,2643,1309,27.252113965,7109,3.6933206733,2628,259
2023-2024,8,07,Outaouais,CISSS DE L'OUTAOUAIS,HÔPITAL DE MANIWAKI,51221893,8093,1091,468,7.0072674259,7020,2.4685209718,5732,519,246,3.5784224529,4729,2.594460304,2361,404,182,15.33176526,2291,2.2085615209,572,222
2023-2024,8,07,Outaouais,CISSS DE L'OUTAOUAIS,HÔPITAL ET CHSLD DE PAPINEAU,51228823,13588,1709,644,9.655594397,10167,3.6722114849,10087,746,240,4.3526692497,6720,3.9271594742,3501,1171,543,24.934259339,3447,3.1751849434,963,404
2023-2024,8,07,Outaouais,CISSS DE L'OUTAOUAIS,HÔPITAL ET CHSLD DU PONTIAC,51219459,6960,831,196,5.5614054917,6358,2.1340948411,5456,553,122,4.3001982527,4857,2.1712952097,1504,155,29,10.136636008,1501,2.0137202976,278,74
2023-2024,8,07,Outaouais,CISSS DE L'OUTAOUAIS,HÔPITAL ET CHSLD MÉMORIAL DE WAKEFIELD / WAKEFIELD MEMORIAL HOSPITAL,51228799,9979,827,262,5.4725626315,8216,2.7630077829,8793,543,190,4.0725442587,7040,2.8840824653,1186,234,69,15.852294126,1176,2.0382069633,284,72
2023-2024,8,08,Abitibi-Témiscamingue,CISSS DE L'ABITIBI-TÉMISCAMINGUE,CENTRE MULTISERVICES DE SANTÉ ET DE SERVICES SOCIAUX DE LA SARRE,51247559,10806,1423,527,5.8797394195,9812,2.2483848859,8918,866,401,4.3925720453,7949,2.3609518318,1888,217,94,12.904399718,1863,1.7680871653,557,126
2023-2024,8,08,Abitibi-Témiscamingue,CISSS DE L'ABITIBI-TÉMISCAMINGUE,CENTRE MULTISERVICES DE SANTÉ ET DE SERVICES SOCIAUX DE TÉMISCAMING-KIPAWA,51247476,3147,285,159,2.8908933552,2970,0.9951418818,2905,229,125,2.2692829413,2731,1.0222228325,242,19,0,10.352786961,239,0.6856938633,56,34
2023-2024,8,08,Abitibi-Témiscamingue,CISSS DE L'ABITIBI-TÉMISCAMINGUE,CENTRE MULTISERVICES DE SANTÉ ET DE SERVICES SOCIAUX DE VILLE-MARIE,51247542,6755,979,347,4.7606760013,5922,2.6026592461,5780,675,251,4.006373366,4958,2.6573414459,975,21,1,9.2323367521,964,2.3214202974,304,96
2023-2024,8,08,Abitibi-Témiscamingue,CISSS DE L'ABITIBI-TÉMISCAMINGUE,HÔPITAL D'AMOS,51228906,14000,1433,598,4.5078701587,12410,1.7750697242,10529,599,443,3.043098664,8983,2.0031585588,3471,199,14,8.9511369602,3427,1.1771934475,834,155
2023-2024,8,08,Abitibi-Témiscamingue,CISSS DE L'ABITIBI-TÉMISCAMINGUE,HÔPITAL DE ROUYN-NORANDA,51228922,15692,2052,833,6.931387756,12252,3.8289742491,12447,1035,520,5.9012645617,9059,4.3860099226,3245,255,6,10.882680021,3193,2.2485839684,1017,313
2023-2024,8,08,Abitibi-Témiscamingue,CISSS DE L'ABITIBI-TÉMISCAMINGUE,HÔPITAL DE VAL-D'OR,51225589,16365,1806,1074,8.1577254982,13400,3.6510926617,13251,1033,755,6.3769797458,10296,4.156235782,3114,671,122,15.735330497,3104,1.9755277241,773,319
2023-2024,8,09,Côte-Nord,CISSS DE LA CÔTE-NORD,CENTRE MULTISERVICES DE SANTÉ ET DE SERVICES SOCIAUX DE FERMONT,51245108,3458,11,234,5.9147048712,2731,2.0460929045,3282,9,222,5.935726691,2555,2.1018256143,176,1,0,5.5226957071,176,1.2370186237,2,12
2023-2024,8,09,Côte-Nord,CISSS DE LA CÔTE-NORD,CENTRE MULTISERVICES DE SANTÉ ET DE SERVICES SOCIAUX DE FORESTVILLE,51218741,6757,897,328,2.9720620591,5560,1.6401570244,6024,701,276,2.4966428268,4902,1.719504454,733,29,2,6.8791909201,658,1.0490307329,196,52
2023-2024,8,09,Côte-Nord,CISSS DE LA CÔTE-NORD,CENTRE MULTISERVICES DE SANTÉ ET DE SERVICES SOCIAUX DE LA BASSE-CÔTE-NORD,51245140,1887,287,65,2.8408716069,1831,0.950014564,1537,210,55,2.5989689511,1485,0.9701977179,350,0,0,3.9031698413,346,0.863390334,77,10
2023-2024,8,09,Côte-Nord,CISSS DE LA CÔTE-NORD,CENTRE MULTISERVICES DE SANTÉ ET DE SERVICES SOCIAUX DE LA MINGANIE,51245116,8549,900,213,2.9624282892,4373,2.2887372005,6047,614,97,1.5381365415,1944,2.4134953704,2502,79,1,6.4047513101,2429,2.188889575,286,116
2023-2024,8,09,Côte-Nord,CISSS DE LA CÔTE-NORD,CENTRE MULTISERVICES DE SANTÉ ET DE SERVICES SOCIAUX DE PORT-CARTIER,51245132,8205,768,428,4.8972876972,7132,2.4660778884,7446,585,392,3.8961489763,6379,2.5975083608,759,130,32,14.718735544,753,1.3526715361,183,36
2023-2024,8,09,Côte-Nord,CISSS DE LA CÔTE-NORD,CENTRE MULTISERVICES DE SANTÉ ET DE SERVICES SOCIAUX DES ESCOUMINS,51218733,5515,810,233,3.6691473255,4936,1.4579728863,4901,584,199,2.869341631,4333,1.5015522348,614,43,11,10.053264115,603,1.1448231067,226,34
2023-2024,8,09,Côte-Nord,CISSS DE LA CÔTE-NORD,CLSC ET HÔPITAL LE ROYER,51228765,13532,2051,910,9.061462603,11846,3.342205034,9992,947,494,5.1955599202,8313,3.8464647406,3540,971,390,19.973355148,3533,2.155703211,1104,416
2023-2024,8,09,Côte-Nord,CISSS DE LA CÔTE-NORD,HÔPITAL ET CLSC DE SEPT-ÎLES,51232023,12684,1422,893,9.3016736965,10063,3.6784430311,8503,557,397,4.9635259124,5995,4.0618062274,4181,941,330,18.124268915,4068,3.1134817819,865,496
2023-2024,8,11,Gaspésie-Îles-de-la-Madeleine,CISSS DE LA GASPÉSIE,CENTRE MULTISERVICES DE SANTÉ ET DE SERVICES SOCIAUX DE GRANDE-VALLÉE,51247732,4088,738,117,1.9380571184,3150,0.9697169312,3765,616,99,1.5752567508,2848,0.9822616261,323,16,1,6.1669840041,302,0.8514146431,122,18
2023-2024,8,11,Gaspésie-Îles-de-la-Madeleine,CISSS DE LA GASPÉSIE,CLSC ET CENTRE DE SERVICES AMBULATOIRES DE MURDOCHVILLE,51221307,1362,183,86,3.0505241475,1336,1.5146966484,1340,178,83,3.0241179519,1315,1.5334980989,22,0,0,4.6589015152,21,0.3373677249,5,3
2023-2024,8,11,Gaspésie-Îles-de-la-Madeleine,CISSS DE LA GASPÉSIE,CLSC ET CENTRE DE SERVICES AMBULATOIRES DE PASPÉBIAC,51220978,8005,1453,291,4.4058408286,7472,1.902427061,6114,897,235,3.4283699524,5638,1.9923719503,1891,93,17,7.5662093836,1834,1.6259225433,556,56
2023-2024,8,11,Gaspésie-Îles-de-la-Madeleine,CISSS DE LA GASPÉSIE,HÔPITAL DE CHANDLER,51227775,9636,1650,407,5.7745526325,8561,1.9459712975,8140,1085,304,3.6784090568,7073,2.0936682533,1496,367,71,17.180039736,1488,1.2439144639,565,103
2023-2024,8,11,Gaspésie-Îles-de-la-Madeleine,CISSS DE LA GASPÉSIE,HÔPITAL DE GASPÉ,51220903,8553,1445,307,5.7849808709,7334,1.7148414159,6810,838,184,3.6978761217,5627,1.9589311948,1743,271,58,13.939417671,1707,0.9102174055,607,123
2023-2024,8,11,Gaspésie-Îles-de-la-Madeleine,CISSS DE LA GASPÉSIE,HÔPITAL ET CLSC DE SAINTE-ANNE-DES-MONTS,51247799,8315,1356,367,5.1456480925,7393,2.0176689661,6551,751,255,3.1751856375,5649,2.149533054,1764,255,55,12.463391597,1744,1.5905472732,605,112
2023-2024,8,11,Gaspésie-Îles-de-la-Madeleine,CISSS DE LA GASPÉSIE,HÔPITAL ET GROUPE DE MÉDECINE DE FAMILLE UNIVERSITAIRE DE MARIA,51227908,10480,1940,518,7.7997687659,9600,2.1674353009,7727,925,262,4.095791992,6856,2.43030229,2753,758,221,18.195928785,2744,1.5106510164,1015,256
2023-2024,8,11,Gaspésie-Îles-de-la-Madeleine,CISSS DES ÎLES,HÔPITAL DE L'ARCHIPEL,51227783,10420,1451,300,4.0762070004,9256,1.5449379682,8454,934,176,2.9402047026,7311,1.6274764434,1966,107,0,8.961132446,1945,1.234686661,517,124
2023-2024,8,12,Chaudière-Appalaches,CISSS DE CHAUDIÈRE-APPALACHES,CHSLD ET HÔPITAL PAUL-GILBERT,51245199,26744,2145,355,2.5568613832,20635,2.0536146784,26078,2073,346,2.531939289,19969,2.0978603224,666,0,0,3.5327147981,666,0.7269761428,72,9
2023-2024,8,12,Chaudière-Appalaches,CISSS DE CHAUDIÈRE-APPALACHES,HÔPITAL DE MONTMAGNY,51245223,20091,3275,578,4.1993865689,18455,1.4477977212,15752,1769,322,2.5827287893,14116,1.6834800148,4339,272,11,10.068387109,4339,0.681056247,1506,256
2023-2024,8,12,Chaudière-Appalaches,CISSS DE CHAUDIÈRE-APPALACHES,HÔPITAL DE SAINT-GEORGES,51228971,27047,5009,1392,6.3264022401,22256,2.418497384,19514,2089,688,3.9026462483,14752,3.0023413021,7533,1002,42,12.605066043,7504,1.2707274639,2920,704
2023-2024,8,12,Chaudière-Appalaches,CISSS DE CHAUDIÈRE-APPALACHES,HÔPITAL DE THETFORD,51245231,23460,3863,711,5.5525094132,21724,1.5808207001,18560,2131,383,3.9297980125,16827,1.7894585752,4900,546,17,11.6989428,4897,0.8639022758,1732,328
2023-2024,8,12,Chaudière-Appalaches,CISSS DE CHAUDIÈRE-APPALACHES,HÔTEL-DIEU DE LÉVIS,51227569,46678,9005,3097,7.9111099209,42179,1.5496053065,32270,3489,1478,3.6110958148,27778,1.9939868981,14408,3617,827,17.541971609,14401,0.6924403977,5516,1619
2023-2024,8,13,Laval,CISSS DE LAVAL,HÔPITAL DE LA CITÉ-DE-LA-SANTÉ,51228757,56008,10781,3495,9.5397001321,43455,2.9925526471,35912,3374,845,5.4023343791,23405,3.8402116357,20096,4341,470,16.933264967,20050,2.0030534636,7407,2650
2023-2024,8,14,Lanaudière,CISSS DE LANAUDIÈRE,HÔPITAL DE LANAUDIÈRE ET CENTRE D'HÉBERGEMENT PARPHILIA-FERLAND,51244945,43889,7754,2974,9.9134861051,35236,2.7480763282,28597,2454,2077,5.8158138674,20042,3.6952963222,15292,4106,906,17.576390433,15194,1.4986237075,5300,897
2023-2024,8,14,Lanaudière,CISSS DE LANAUDIÈRE,HÔPITAL PIERRE-LE GARDEUR,51228062,45534,8313,2599,10.873748847,29141,5.6596174443,30456,2923,886,6.6877390881,14144,7.1390389525,15078,4974,360,19.329055467,14997,4.2643425352,5390,1713
2023-2024,8,15,Laurentides,CISSS DES LAURENTIDES,CENTRE MULTISERVICES DE SANTÉ ET DE SERVICES SOCIAUX D'ARGENTEUIL,51245306,12067,1569,378,8.9114878272,9739,3.5870156644,10008,902,237,5.7863329614,7689,4.0672705958,2059,773,290,24.101652906,2050,1.7857082656,667,141
2023-2024,8,15,Laurentides,CISSS DES LAURENTIDES,CENTRE MULTISERVICES DE SANTÉ ET DE SERVICES SOCIAUX DE RIVIÈRE-ROUGE,51217628,8880,1076,524,6.3136621934,7797,2.8886177732,6969,637,283,4.1866401604,5927,3.0484179742,1911,333,76,14.07044741,1870,2.3821280452,439,241
2023-2024,8,15,Laurentides,CISSS DES LAURENTIDES,CENTRE MULTISERVICES DE SANTÉ ET DE SERVICES SOCIAUX DE SAINTE-AGATHE,51246874,19267,3666,1157,11.363529927,15445,3.9579662242,12466,1422,328,6.3954372337,8718,5.0143570136,6801,2199,468,20.46987363,6727,2.5889139124,2244,829
2023-2024,8,15,Laurentides,CISSS DES LAURENTIDES,HÔPITAL DE MONT-LAURIER,51217610,10983,1582,595,10.152747655,8868,3.8816370345,8144,808,290,6.8027916598,6068,4.2942662327,2839,771,220,19.762484052,2800,2.9874106151,774,305
2023-2024,8,15,Laurentides,CISSS DES LAURENTIDES,HÔPITAL DE SAINT-EUSTACHE,51228864,30854,6399,1939,12.692207349,21715,4.0724600251,18665,1801,494,7.5757060005,9603,6.082818419,12189,4113,846,20.527099274,12112,2.4785472397,4598,1445
2023-2024,8,15,Laurentides,CISSS DES LAURENTIDES,HÔPITAL DE SAINT-JÉRÔME,51228880,35319,6482,3445,14.309860195,25092,4.6252866341,20314,2118,892,6.9276895928,10211,6.4742049152,15005,5297,2125,24.303956403,14881,3.3566014269,4364,2553
2023-2024,8,16,Montérégie,CISSS DE LA MONTÉRÉGIE-CENTRE,HÔPITAL CHARLES-LE MOYNE,51233799,46798,8613,3603,9.7235960404,25865,5.3345286101,32597,3504,1430,5.9337955095,11677,6.3197344019,14201,4131,293,18.422710744,14188,4.5236850782,5109,2173
2023-2024,8,16,Montérégie,CISSS DE LA MONTÉRÉGIE-CENTRE,HÔPITAL DU HAUT-RICHELIEU,51229045,37651,6355,2157,10.514602829,29161,3.4941187145,25686,2175,667,5.7569081082,17344,4.3454335793,11965,3588,1587,20.728238148,11817,2.2446302643,4180,1490
2023-2024,8,16,Montérégie,CISSS DE LA MONTÉRÉGIE-EST,HÔPITAL HONORÉ-MERCIER,51229193,28145,5533,1454,9.6849236592,21845,4.2924455762,16089,1976,608,6.2888668759,9983,5.7078081349,12056,2347,424,14.21703693,11862,3.1012835104,3557,846
2023-2024,8,16,Montérégie,CISSS DE LA MONTÉRÉGIE-EST,HÔPITAL PIERRE-BOUCHER,51229011,36020,7807,2137,13.063992149,25777,5.0737691439,17820,2583,667,6.7502469136,7787,6.7635030963,18200,4799,1684,19.245911935,17990,4.3423651257,5224,1470
2023-2024,8,16,Montérégie,CISSS DE LA MONTÉRÉGIE-EST,HÔTEL-DIEU DE SOREL,51229102,22702,3592,1163,7.6827509079,19635,2.2639311179,15592,1457,392,3.8839005758,12581,2.5275010156,7110,1772,252,16.013506798,7054,1.7938470686,2135,771
2023-2024,8,16,Montérégie,CISSS DE LA MONTÉRÉGIE-OUEST,HÔPITAL ANNA-LABERGE,51229151,23090,4964,1467,18.227780665,17778,2.6281998038,14240,1503,334,10.661368602,8929,4.1684318264,8850,4273,1888,30.402436911,8849,1.0740432064,3461,1133
2023-2024,8,16,Montérégie,CISSS DE LA MONTÉRÉGIE-OUEST,HÔPITAL BARRIE MEMORIAL / BARRIE MEMORIAL HOSPITAL,51228005,13561,1534,223,6.1399161402,11305,3.276416163,11499,957,174,4.3756910021,9260,3.1802891769,2062,476,90,15.978337509,2045,3.7116904374,577,49
2023-2024,8,16,Montérégie,CISSS DE LA MONTÉRÉGIE-OUEST,HÔPITAL DU SUROÎT,51229136,24443,4924,1877,12.800909372,19391,2.4688212888,16100,1642,1100,4.8584571256,11074,3.3201237383,8343,3124,1604,28.127947747,8317,1.3353208288,3282,777
2024-2025,8,01,Bas-Saint-Laurent,CISSS DU BAS-SAINT-LAURENT,CENTRE HOSPITALIER RÉGIONAL DU GRAND-PORTAGE,51218352,14327,2878,705,5.1317396253,11799,2.3360392594,10441,1236,400,3.4116626494,7935,2.6451080305,3886,111,0,9.7532845828,3864,1.7013444617,1642,305
2024-2025,8,01,Bas-Saint-Laurent,CISSS DU BAS-SAINT-LAURENT,CENTRE MULTISERVICES DE SANTÉ ET DE SERVICES SOCIAUX DE TROIS-PISTOLES,51236156,8210,1169,225,3.204317296,7468,1.5743917381,7118,777,166,2.6145450891,6394,1.6681849738,1092,10,1,7.0486383293,1074,1.015998862,392,59
2024-2025,8,01,Bas-Saint-Laurent,CISSS DU BAS-SAINT-LAURENT,CLSC DE POHÉNÉGAMOOK,51219418,8573,1004,285,1.8130002787,7998,1.0286996749,8125,875,273,1.5413797607,7552,1.0353332083,448,12,0,6.7391536458,446,0.9163758097,129,12
2024-2025,8,01,Bas-Saint-Laurent,CISSS DU BAS-SAINT-LAURENT,HÔPITAL D'AMQUI,51226892,10010,1556,323,4.6392117605,8685,1.8025260986,7093,737,209,3.5296349687,5884,2.1331875991,2917,141,14,7.3372673599,2801,1.1079126502,819,114
2024-2025,8,01,Bas-Saint-Laurent,CISSS DU BAS-SAINT-LAURENT,HÔPITAL DE MATANE,51218980,11379,2046,465,5.4586463124,10151,2.6310937893,8386,1002,264,4.3575692954,7228,2.9598752152,2993,218,22,8.5437221109,2923,1.8180824495,1044,201
2024-2025,8,01,Bas-Saint-Laurent,CISSS DU BAS-SAINT-LAURENT,HÔPITAL DE NOTRE-DAME-DU-LAC,51221877,9336,1626,253,3.5654657003,8341,1.5852864032,7468,931,132,2.529198283,6482,1.7813399499,1868,33,1,7.7083163812,1859,0.9016828044,695,121
2024-2025,8,01,Bas-Saint-Laurent,CISSS DU BAS-SAINT-LAURENT,HÔPITAL NOTRE-DAME-DE-FATIMA,51221141,11754,2023,340,4.3444849744,10647,2.0582472893,9354,1086,171,3.3133862519,8283,2.2409476236,2400,50,1,8.3631922454,2364,1.4181005593,937,169
2024-2025,8,01,Bas-Saint-Laurent,CISSS DU BAS-SAINT-LAURENT,HÔPITAL RÉGIONAL DE RIMOUSKI,51227882,20415,3808,1155,6.6706763137,16100,2.6783851277,14579,1732,662,4.5783000282,10314,3.228086339,5836,704,81,11.897673207,5786,1.6984994911,2076,493
2024-2025,8,02,Saguenay-Lac-Saint-Jean,CIUSSS DU SAGUENAY - LAC-SAINT-JEAN,HÔPITAL D'ALMA,51219400,24065,3787,923,5.012897823,19077,3.1001962223,18763,2124,433,4.0363370285,13903,3.3852889265,5302,91,1,8.468803177,5174,2.3341266697,1663,490
2024-2025,8,02,Saguenay-Lac-Saint-Jean,CIUSSS DU SAGUENAY - LAC-SAINT-JEAN,HÔPITAL DE CHICOUTIMI,51218394,34436,5723,2088,8.0796043546,29927,2.9542120549,19485,1756,568,4.5566037978,15122,3.9548308939,14951,2044,131,12.670980574,14805,1.9321682802,3967,1520
2024-2025,8,02,Saguenay-Lac-Saint-Jean,CIUSSS DU SAGUENAY - LAC-SAINT-JEAN,HÔPITAL DE DOLBEAU-MISTASSINI,51219384,14487,2375,483,4.8043594065,12879,2.3132317899,12223,1564,294,3.5606041661,10630,2.4981861346,2264,221,47,11.519209364,2249,1.4390367324,811,189
2024-2025,8,02,Saguenay-Lac-Saint-Jean,CIUSSS DU SAGUENAY - LAC-SAINT-JEAN,HÔPITAL DE LA BAIE,51221364,12440,1684,382,5.6674928546,11230,2.8982252647,9458,745,215,4.3509733676,8278,3.208551549,2982,84,2,9.8430935614,2952,2.0280081301,939,167
2024-2025,8,02,Saguenay-Lac-Saint-Jean,CIUSSS DU SAGUENAY - LAC-SAINT-JEAN,HÔPITAL ET CENTRE D'HÉBERGEMENT DE ROBERVAL,51228203,16620,2398,907,5.5919656705,14808,2.5615514887,11665,1069,291,3.7987656332,9954,2.8184405208,4955,331,10,9.8134951228,4854,2.0347543263,1329,616
2024-2025,8,02,Saguenay-Lac-Saint-Jean,CIUSSS DU SAGUENAY - LAC-SAINT-JEAN,HÔPITAL ET CENTRE DE RÉADAPTATION DE JONQUIÈRE,51224541,17677,3329,916,7.3917176746,13905,3.7925300052,11150,1151,362,4.7160016941,7600,4.1632539474,6527,572,17,11.962612907,6305,3.3456621288,2178,554
2024-2025,8,03,Capitale-Nationale,CHU DE QUÉBEC - UNIVERSITÉ LAVAL,CENTRE HOSPITALIER DE L'UNIVERSITÉ LAVAL,51217594,48460,4488,4639,8.1774359151,38947,2.4721995062,27448,909,1579,5.1005954694,18080,3.6361077311,21012,2397,431,12.196716162,20867,1.4637430579,3579,3060
2024-2025,8,03,Capitale-Nationale,CHU DE QUÉBEC - UNIVERSITÉ LAVAL,HÔPITAL DE L'ENFANT-JÉSUS,51233914,41695,7248,5048,9.9657446603,37077,1.8519504829,23363,2378,1335,4.305553356,18890,2.385644815,18332,4455,816,17.179308344,18187,1.2976267389,4870,3713
2024-2025,8,03,Capitale-Nationale,CHU DE QUÉBEC - UNIVERSITÉ LAVAL,HÔPITAL DU SAINT-SACREMENT,51217529,23880,5551,702,7.6131197655,19493,2.1634521937,16885,2268,250,3.9016808969,12514,2.6179823043,6995,1767,235,16.572039751,6979,1.3484371766,3283,452
2024-2025,8,03,Capitale-Nationale,CHU DE QUÉBEC - UNIVERSITÉ LAVAL,HÔPITAL SAINT-FRANÇOIS D'ASSISE,51217602,26532,6970,864,10.918961694,21606,2.5018085254,15221,1964,423,5.1077478849,10334,3.5752631551,11311,3495,397,18.739002839,11272,1.5176814723,5006,441
2024-2025,8,03,Capitale-Nationale,CHU DE QUÉBEC - UNIVERSITÉ LAVAL,L'HÔTEL-DIEU DE QUÉBEC,51217586,15040,3296,687,7.0676425827,13309,1.8645328767,8229,767,289,3.4839581561,6592,2.1561421251,6811,534,12,11.397423694,6717,1.57835033,2529,398
2024-2025,8,03,Capitale-Nationale,CIUSSS DE LA CAPITALE-NATIONALE,CENTRE MULTISERVICES DE SANTÉ ET DE SERVICES SOCIAUX CHAUVEAU,51225001,28282,2033,427,2.9732588553,19589,1.7724722208,25851,1753,377,2.8380505052,17199,1.8786696255,2431,0,0,4.4110503222,2390,1.0082508136,280,50
2024-2025,8,03,Capitale-Nationale,CIUSSS DE LA CAPITALE-NATIONALE,CENTRE MULTISERVICES DE SANTÉ ET DE SERVICES SOCIAUX DE BAIE-SAINT-PAUL,51244804,8914,1514,268,5.4026130868,6856,2.3755827823,7219,902,136,3.4259826692,5179,2.6522455536,1695,244,42,13.821076205,1677,1.5211781952,612,132
2024-2025,8,03,Capitale-Nationale,CIUSSS DE LA CAPITALE-NATIONALE,CENTRE MULTISERVICES DE SANTÉ ET DE SERVICES SOCIAUX DE SAINT-MARC-DES-CARRIÈRES,51247344,12169,1583,237,2.8521352298,10004,1.5402734739,10218,959,152,2.2785666634,8087,1.7372742605,1951,31,4,5.8560940259,1917,0.7092117313,624,85
2024-2025,8,03,Capitale-Nationale,CIUSSS DE LA CAPITALE-NATIONALE,CENTRE MULTISERVICES DE SANTÉ ET DE SERVICES SOCIAUX DE SAINT-RAYMOND,51247302,13229,1928,284,4.4688223264,10549,2.1434169906,10632,1047,168,3.4582111655,7989,2.4639798821,2597,120,20,8.6062185,2560,1.1430353733,881,116
2024-2025,8,03,Capitale-Nationale,CIUSSS DE LA CAPITALE-NATIONALE,CENTRE MULTISERVICES DE SANTÉ ET DE SERVICES SOCIAUX DE SAINTE-ANNE-DE-BEAUPRÉ,51225357,10721,1266,163,4.2914174155,8098,2.2127229631,9007,748,106,3.3963391128,6425,2.4453587981,1714,85,12,8.9950173409,1673,1.3193068008,518,57
2024-2025,8,03,Capitale-Nationale,CIUSSS DE LA CAPITALE-NATIONALE,HÔPITAL ET CLSC DE LA MALBAIE,51228690,9870,1742,257,4.9196188225,8112,1.9235315308,8194,1158,148,3.3508482833,6442,2.1910149539,1676,198,27,12.589371685,1670,0.8917182302,584,109
2024-2025,8,03,Capitale-Nationale,INSTITUT UNIVERSITAIRE DE CARDIOLOGIE ET DE PNEUMOLOGIE DE QUÉBEC - UNIVERSITÉ LAVAL,INSTITUT UNIVERSITAIRE DE CARDIOLOGIE ET DE PNEUMOLOGIE DE QUÉBEC,51232130,19442,6540,382,7.9196161089,18128,2.0586560385,10222,2339,199,4.0656055023,8936,2.6053056302,9220,981,0,12.192468215,9192,1.5272308046,4201,183
2024-2025,8,04,Mauricie et Centre-du-Québec,CIUSSS DE LA MAURICIE-ET-DU-CENTRE-DU-QUÉBEC,CENTRE MULTISERVICES DE SANTÉ ET DE SERVICES SOCIAUX AVELLIN-DALCOURT,51233583,14725,2163,333,4.9558570081,11708,3.0250351137,12557,1273,176,4.2100316999,9570,3.376571752,2168,91,13,9.2756579285,2138,1.4515058206,890,157
2024-2025,8,04,Mauricie et Centre-du-Québec,CIUSSS DE LA MAURICIE-ET-DU-CENTRE-DU-QUÉBEC,CENTRE MULTISERVICES DE SANTÉ ET DE SERVICES SOCIAUX CHRIST-ROI,51246338,15099,1757,423,5.2474573371,12103,3.485036194,12211,831,243,4.3799363506,9335,3.7970093138,2888,154,22,8.915497076,2768,2.4329158638,926,180
2024-2025,8,04,Mauricie et Centre-du-Québec,CIUSSS DE LA MAURICIE-ET-DU-CENTRE-DU-QUÉBEC,CENTRE MULTISERVICES DE SANTÉ ET DE SERVICES SOCIAUX DE FORTIERVILLE,51219160,8786,947,139,2.7883495207,6639,2.1863891399,8102,837,128,2.6885554664,5961,2.2889524968,684,0,0,3.9704130117,678,1.2846484759,110,11
2024-2025,8,04,Mauricie et Centre-du-Québec,CIUSSS DE LA MAURICIE-ET-DU-CENTRE-DU-QUÉBEC,CENTRE MULTISERVICES DE SANTÉ ET DE SERVICES SOCIAUX DU HAUT-SAINT-MAURICE,51219731,8175,1179,451,5.951861366,7074,2.7190733673,6137,666,227,4.1168359495,5072,2.9520559499,2038,154,5,11.477646931,2002,2.1288197913,513,224
2024-2025,8,04,Mauricie et Centre-du-Québec,CIUSSS DE LA MAURICIE-ET-DU-CENTRE-DU-QUÉBEC,HÔPITAL DU CENTRE-DE-LA-MAURICIE,51220051,22765,4470,1538,7.4756584791,18445,3.0077775519,14086,1369,349,4.988244435,9817,4.3416235159,8679,829,54,11.512726601,8628,1.490118091,3101,1189
2024-2025,8,04,Mauricie et Centre-du-Québec,CIUSSS DE LA MAURICIE-ET-DU-CENTRE-DU-QUÉBEC,HÔPITAL SAINTE-CROIX,51228781,27633,4392,1671,8.2975525941,20201,3.9272968472,15721,1297,440,6.3258803688,8705,5.4410863808,11912,951,9,10.899689855,11496,2.7810252842,3095,1231
2024-2025,8,04,Mauricie et Centre-du-Québec,CIUSSS DE LA MAURICIE-ET-DU-CENTRE-DU-QUÉBEC,HÔTEL-DIEU D'ARTHABASKA,51228039,24980,4806,1371,6.1786376323,20554,2.6268437882,14649,1659,253,4.5708267914,10451,3.474555731,10331,370,3,8.4584576894,10103,1.7499322259,3147,1118
2024-2025,8,04,Mauricie et Centre-du-Québec,CIUSSS DE LA MAURICIE-ET-DU-CENTRE-DU-QUÉBEC,PAVILLON SAINTE-MARIE,51220168,39138,9184,2267,10.102597859,29799,3.556344126,21570,2340,658,5.6743202364,12403,5.2085175406,17568,3663,302,15.539639543,17396,2.3783775325,6844,1609
2024-2025,8,05,Estrie,CIUSSS DE L'ESTRIE - CENTRE HOSPITALIER UNIVERSITAIRE DE SHERBROOKE,CENTRE DE SANTÉ ET DE SERVICES SOCIAUX DU GRANIT,51223832,10222,1666,267,5.1623331485,8782,3.0880149422,8266,1020,152,4.2615546953,6847,3.3357445678,1956,73,0,8.9689971029,1935,2.2114233419,646,115
2024-2025,8,05,Estrie,CIUSSS DE L'ESTRIE - CENTRE HOSPITALIER UNIVERSITAIRE DE SHERBROOKE,CENTRE MULTISERVICES DE SANTÉ ET DE SERVICES SOCIAUX DE LA MRC DE COATICOOK,51247617,14143,1096,406,3.0020689466,11232,2.2928537512,11723,760,324,2.8683220071,8876,2.4681456862,2420,0,0,3.6499678604,2356,1.6324584984,336,82
2024-2025,8,05,Estrie,CIUSSS DE L'ESTRIE - CENTRE HOSPITALIER UNIVERSITAIRE DE SHERBROOKE,CENTRE MULTISERVICES DE SANTÉ ET DE SERVICES SOCIAUX DE MEMPHRÉMAGOG,51219046,15987,3217,530,7.1946281875,12270,4.1145062483,11738,1524,255,5.2638642775,8159,4.7336742997,4249,599,114,12.52842597,4111,2.885658734,1693,275
2024-2025,8,05,Estrie,CIUSSS DE L'ESTRIE - CENTRE HOSPITALIER UNIVERSITAIRE DE SHERBROOKE,CENTRE MULTISERVICES DE SANTÉ ET DE SERVICES SOCIAUX DES SOURCES,51247583,12099,1512,401,5.1581556327,10025,3.5840389305,10536,1016,285,4.6162961117,8493,3.8487474979,1563,73,4,8.8107672212,1532,2.1165651291,496,116
2024-2025,8,05,Estrie,CIUSSS DE L'ESTRIE - CENTRE HOSPITALIER UNIVERSITAIRE DE SHERBROOKE,CHUS - HÔPITAL FLEURIMONT,51216687,29788,4373,701,9.0507419095,25086,3.1284494672,15496,878,235,6.85937984,10797,5.537593776,14292,1528,42,11.426710747,14289,1.3080609793,3495,466
2024-2025,8,05,Estrie,CIUSSS DE L'ESTRIE - CENTRE HOSPITALIER UNIVERSITAIRE DE SHERBROOKE,CHUS - HÔTEL-DIEU DE SHERBROOKE,51216695,30110,6550,3489,11.422609875,25345,3.570765437,15109,1693,843,7.1280164141,10376,5.6279218067,15001,2446,601,15.748122347,14969,2.1448148396,4857,2646
2024-2025,8,05,Estrie,CIUSSS DE L'ESTRIE - CENTRE HOSPITALIER UNIVERSITAIRE DE SHERBROOKE,HÔPITAL BROME-MISSISQUOI-PERKINS,51229185,19124,3134,644,9.5278562133,15426,4.4359913638,13097,976,241,6.0844074767,9473,5.1629762072,6027,1626,132,17.010658288,5953,3.2791414693,2158,403
2024-2025,8,05,Estrie,CIUSSS DE L'ESTRIE - CENTRE HOSPITALIER UNIVERSITAIRE DE SHERBROOKE,HÔPITAL DE GRANBY,51228120,24464,4119,1430,12.322189578,18182,5.6164217358,17079,1630,556,8.3927928873,10832,7.2409334995,7385,2799,413,21.409551268,7350,3.2223113379,2489,874
2024-2025,8,06,Montréal,CENTRE HOSPITALIER DE L'UNIVERSITÉ DE MONTRÉAL,CENTRE HOSPITALIER DE L'UNIVERSITÉ DE MONTRÉAL,51236297,49857,7396,4130,12.011826663,36090,3.137048336,29770,2130,1368,7.4846407271,16152,5.1320774173,20087,5982,627,18.721356474,19938,1.5208526432,5266,2762
2024-2025,8,06,Montréal,CENTRE HOSPITALIER UNIVERSITAIRE SAINTE-JUSTINE,CHU SAINTE-JUSTINE,51222800,51387,1,1261,4.8943013851,44565,1.7107515053,33145,0,457,4.107431027,26728,2.2028973049,18242,243,6,6.3240140275,17837,0.9732915662,1,804
2024-2025,8,06,Montréal,CENTRE UNIVERSITAIRE DE SANTÉ MCGILL,HÔPITAL DE LACHINE,51228310,12869,1995,389,10.705723487,10668,3.4041932258,9896,909,177,5.3464385161,7723,3.6694777145,2973,1051,556,28.544769593,2945,2.7085083003,1086,212
2024-2025,8,06,Montréal,CENTRE UNIVERSITAIRE DE SANTÉ MCGILL,HÔPITAL GÉNÉRAL DE MONTRÉAL,51248219,22186,3144,2845,16.561908436,19116,1.6942110594,10290,801,596,5.762670203,7316,2.4742566521,11896,3649,1877,25.903213195,11800,1.2105827919,2343,2249
2024-2025,8,06,Montréal,CENTRE UNIVERSITAIRE DE SANTÉ MCGILL,HÔPITAL ROYAL VICTORIA,51223295,30499,5064,743,17.455290993,22806,4.6266054133,18339,1251,308,9.2261785448,10893,6.5905491549,12160,5193,2429,29.865956552,11913,2.8308160087,3813,435
2024-2025,8,06,Montréal,CENTRE UNIVERSITAIRE DE SANTÉ MCGILL,L'HÔPITAL DE MONTRÉAL POUR ENFANTS,51223279,47566,7,1443,5.5241239074,43635,1.6706727207,37181,2,423,4.6561216676,33275,1.9157710577,10385,377,13,8.631797598,10360,0.8834480909,5,1020
2024-2025,8,06,Montréal,CIUSSS DE L'EST-DE-L'ÎLE-DE-MONTRÉAL,HÔPITAL MAISONNEUVE-ROSEMONT,12934659,45443,7928,2696,11.847855299,31627,3.649463196,27676,2168,603,5.4130869104,14044,5.2268672664,17767,6108,1818,21.871418641,17583,2.3895494859,5760,2093
2024-2025,8,06,Montréal,CIUSSS DE L'EST-DE-L'ÎLE-DE-MONTRÉAL,HÔPITAL SANTA CABRINI,51235919,23736,6055,869,13.905867669,18048,3.3660571809,13584,1491,317,5.8168485596,7957,5.0066965844,10152,3810,1460,24.729472436,10091,2.0723729341,4564,552
2024-2025,8,06,Montréal,CIUSSS DE L'EST-DE-L'ÎLE-DE-MONTRÉAL,INSTITUT UNIVERSITAIRE EN SANTÉ MENTALE DE MONTRÉAL,51235307,3234,138,3225,12.241052103,3154,1.2723569717,1607,59,1602,3.278405241,1527,1.3333688059,1627,486,137,21.093525063,1627,1.2150950966,79,1623
2024-2025,8,06,Montréal,CIUSSS DE L'OUEST-DE-L'ÎLE-DE-MONTRÉAL,CENTRE HOSPITALIER DE ST. MARY,51248243,22711,4636,1627,10.448127107,20181,2.7928350786,14261,1416,523,6.1834081878,11752,3.5785478831,8450,2021,203,17.645660421,8429,1.697367422,3220,1104
2024-2025,8,06,Montréal,CIUSSS DE L'OUEST-DE-L'ÎLE-DE-MONTRÉAL,HÔPITAL DE LASALLE,51224392,18555,2905,543,9.5412453966,14927,3.5721395048,14216,1196,198,5.846174889,10617,4.2380308572,4339,1432,510,21.64751927,4310,1.9318219902,1709,345
2024-2025,8,06,Montréal,CIUSSS DE L'OUEST-DE-L'ÎLE-DE-MONTRÉAL,HÔPITAL DOUGLAS,51235190,4086,104,3959,13.114148923,3785,2.2495923235,2061,46,1946,4.1460779557,1764,2.3792139078,2025,715,106,22.241652263,2021,2.1364540382,58,2013
2024-2025,8,06,Montréal,CIUSSS DE L'OUEST-DE-L'ÎLE-DE-MONTRÉAL,HÔPITAL GÉNÉRAL DU LAKESHORE,51228278,25381,6115,1543,14.471585482,20309,3.1550908601,15262,1638,196,7.5707396002,10241,4.2493155237,10119,3824,1315,24.879798728,10068,2.042063965,4477,1347
2024-2025,8,06,Montréal,CIUSSS DU CENTRE-OUEST-DE-L'ÎLE-DE-MONTRÉAL,HÔPITAL GÉNÉRAL JUIF,51248250,61509,11649,3187,10.900573814,52761,2.5922478935,21425,1374,304,3.756429742,13711,2.9806787535,40084,6476,2034,14.719137,39050,2.4558643975,10275,2883
2024-2025,8,06,Montréal,CIUSSS DU CENTRE-SUD-DE-L'ÎLE-DE-MONTRÉAL,HÔPITAL DE VERDUN,51218097,28574,5070,1613,9.5973545784,23910,2.4654848041,19150,1673,591,4.8976241659,14517,3.2066792381,9424,2933,469,19.147422214,9393,1.3199594556,3397,1022
2024-2025,8,06,Montréal,CIUSSS DU CENTRE-SUD-DE-L'ÎLE-DE-MONTRÉAL,HÔPITAL NOTRE-DAME,51236313,25013,3619,3652,11.656205329,20963,2.2515738709,15271,758,1458,5.955691525,11253,3.1617372404,9742,2853,492,20.592003553,9710,1.1967779494,2861,2194
2024-2025,8,06,Montréal,CIUSSS DU NORD-DE-L'ÎLE-DE-MONTRÉAL,HÔPITAL DU SACRÉ-COEUR-DE-MONTRÉAL,12475976,43477,8208,2021,11.969410103,32537,3.6225567303,29280,2597,797,6.8603367297,18381,5.1790752377,14197,5573,1480,22.506401607,14156,1.6014796827,5611,1224
2024-2025,8,06,Montréal,CIUSSS DU NORD-DE-L'ÎLE-DE-MONTRÉAL,HÔPITAL EN SANTÉ MENTALE ALBERT-PRÉVOST,51848752,2212,96,2204,23.577659735,2183,0.4560636484,962,49,954,4.8402425502,933,0.6486971537,1250,831,386,37.997976,1250,0.312282,47,1250
2024-2025,8,06,Montréal,CIUSSS DU NORD-DE-L'ÎLE-DE-MONTRÉAL,HÔPITAL FLEURY,51228492,20500,3527,540,9.7148629404,15135,3.6179197409,14937,1319,249,5.6383120216,9595,4.5283508482,5563,1863,311,20.660654972,5540,2.0410990774,2208,291
2024-2025,8,06,Montréal,CIUSSS DU NORD-DE-L'ÎLE-DE-MONTRÉAL,HÔPITAL JEAN-TALON,51228500,27668,3610,2166,8.1049303849,19695,3.4639326817,20679,1182,775,5.2737410739,12740,4.5020586953,6989,1684,131,16.481831767,6955,1.5623186756,2428,1391
2024-2025,8,06,Montréal,INSTITUT DE CARDIOLOGIE DE MONTRÉAL,INSTITUT DE CARDIOLOGIE DE MONTRÉAL,51248201,12798,3467,307,7.2519033139,12365,1.5986729568,8504,1747,275,3.6007212946,8071,1.8442147469,4294,695,39,14.482842273,4294,1.1371527454,1720,32
2024-2025,8,07,Outaouais,CISSS DE L'OUTAOUAIS,CENTRE MULTISERVICES DE SANTÉ ET DE SERVICES SOCIAUX DE MANSFIELD-ET-PONTEFRACT,51245058,6365,724,157,3.7625054552,5919,1.7514358187,6175,684,150,3.5908360324,5729,1.7513195051,190,8,0,9.3417616959,190,1.7549429825,40,7
2024-2025,8,07,Outaouais,CISSS DE L'OUTAOUAIS,CLSC ET CENTRE D'HÉBERGEMENT DE LA PETITE-NATION,51219491,7506,973,267,3.6259945747,6378,2.0005971482,6867,770,253,3.5202475203,5743,2.1240271732,639,2,0,4.7624030603,635,0.8842843395,203,14
2024-2025,8,07,Outaouais,CISSS DE L'OUTAOUAIS,HÔPITAL DE GATINEAU,51221703,25411,3558,3078,13.2150818,16004,6.3746987212,15569,1173,744,7.4015371714,6706,7.1524214219,9842,2948,865,22.411492724,9298,5.8137814883,2385,2334
2024-2025,8,07,Outaouais,CISSS DE L'OUTAOUAIS,HÔPITAL DE HULL,51221711,22965,4567,726,13.25389738,15375,5.7140737669,14444,1339,419,7.7098801309,7117,6.783065157,8521,2990,996,22.651595437,8258,4.7927838998,3228,307
2024-2025,8,07,Outaouais,CISSS DE L'OUTAOUAIS,HÔPITAL DE MANIWAKI,51221893,9199,1256,508,6.6926191253,7816,2.59280756,6810,672,260,3.7302181433,5491,2.7151656751,2389,450,159,15.137135947,2325,2.3038318996,584,248
2024-2025,8,07,Outaouais,CISSS DE L'OUTAOUAIS,HÔPITAL ET CHSLD DE PAPINEAU,51228823,15953,2050,713,8.5121187412,11592,4.3190990194,11696,874,289,4.6456508635,7413,4.6409993705,4257,1180,275,19.135141597,4179,3.748089854,1176,424
2024-2025,8,07,Outaouais,CISSS DE L'OUTAOUAIS,HÔPITAL ET CHSLD DU PONTIAC,51219459,8104,980,253,5.8692448859,7351,2.5072257743,7295,809,187,4.8849408651,6545,2.5713555725,809,132,37,14.745014764,806,1.9864695341,171,66
2024-2025,8,07,Outaouais,CISSS DE L'OUTAOUAIS,HÔPITAL ET CHSLD MÉMORIAL DE WAKEFIELD / WAKEFIELD MEMORIAL HOSPITAL,51228799,11113,909,252,5.8750285951,9043,3.4678318405,9764,589,168,4.7341395546,7716,3.6155906198,1349,223,28,14.132731035,1327,2.6086707695,320,84
2024-2025,8,08,Abitibi-Témiscamingue,CISSS DE L'ABITIBI-TÉMISCAMINGUE,CENTRE MULTISERVICES DE SANTÉ ET DE SERVICES SOCIAUX DE LA SARRE,51247559,12338,1575,626,5.9306118181,10814,2.9211218482,10078,953,470,4.9590904556,8592,3.0874286481,2260,230,22,10.262909292,2222,2.2780489299,622,156
2024-2025,8,08,Abitibi-Témiscamingue,CISSS DE L'ABITIBI-TÉMISCAMINGUE,CENTRE MULTISERVICES DE SANTÉ ET DE SERVICES SOCIAUX DE TÉMISCAMING-KIPAWA,51247476,3478,335,234,2.4615701073,3271,0.9214399266,3250,270,209,1.9163352991,3043,0.9403529047,228,10,0,10.233557505,228,0.6690180312,65,25
2024-2025,8,08,Abitibi-Témiscamingue,CISSS DE L'ABITIBI-TÉMISCAMINGUE,CENTRE MULTISERVICES DE SANTÉ ET DE SERVICES SOCIAUX DE VILLE-MARIE,51247542,7827,1103,356,4.6820602473,6707,2.6410775227,6616,722,243,3.8457838741,5515,2.718223431,1211,27,2,9.250850078,1192,2.2841482569,381,113
2024-2025,8,08,Abitibi-Témiscamingue,CISSS DE L'ABITIBI-TÉMISCAMINGUE,HÔPITAL D'AMOS,51228906,16492,1827,675,4.8262789534,14850,2.063470015,12560,821,515,3.4604257564,10960,2.3102059509,3932,275,18,9.1892281282,3890,1.3682962725,1006,160
2024-2025,8,08,Abitibi-Témiscamingue,CISSS DE L'ABITIBI-TÉMISCAMINGUE,HÔPITAL DE ROUYN-NORANDA,51228922,18182,2389,1051,7.3332565174,13804,4.3023079059,14735,1246,711,6.5131484372,10411,4.8911206363,3447,247,3,10.838998485,3393,2.4956090153,1143,340
2024-2025,8,08,Abitibi-Témiscamingue,CISSS DE L'ABITIBI-TÉMISCAMINGUE,HÔPITAL DE VAL-D'OR,51225589,17887,2078,1136,8.0277421063,14387,4.2775096152,14736,1209,809,6.2092384862,11251,4.8517707315,3151,761,145,16.532175412,3136,2.2172379889,869,327
2024-2025,8,09,Côte-Nord,CISSS DE LA CÔTE-NORD,CENTRE MULTISERVICES DE SANTÉ ET DE SERVICES SOCIAUX DE FERMONT,51245108,4119,28,271,6.2072433304,3598,2.5944305478,3867,23,249,6.0522418326,3348,2.6686773198,252,2,1,8.5857782187,250,1.6001177778,5,22
2024-2025,8,09,Côte-Nord,CISSS DE LA CÔTE-NORD,CENTRE MULTISERVICES DE SANTÉ ET DE SERVICES SOCIAUX DE FORESTVILLE,51218741,6771,1004,354,3.9075897619,5470,2.2752344099,5872,744,278,3.3113497673,4672,2.4677344345,899,45,8,7.8020516623,798,1.1482167224,260,76
2024-2025,8,09,Côte-Nord,CISSS DE LA CÔTE-NORD,CENTRE MULTISERVICES DE SANTÉ ET DE SERVICES SOCIAUX DE LA BASSE-CÔTE-NORD,51245140,2422,386,80,2.7416477429,2364,0.8691274206,2014,283,68,2.4902597098,1956,0.8925925926,408,1,0,3.9825680828,408,0.7566326253,103,12
2024-2025,8,09,Côte-Nord,CISSS DE LA CÔTE-NORD,CENTRE MULTISERVICES DE SANTÉ ET DE SERVICES SOCIAUX DE LA MINGANIE,51245116,8062,875,285,3.6717132501,4629,2.6496925782,5475,607,107,2.0499429224,2117,2.762741563,2587,109,7,7.1039484817,2512,2.5544200062,268,178
2024-2025,8,09,Côte-Nord,CISSS DE LA CÔTE-NORD,CENTRE MULTISERVICES DE SANTÉ ET DE SERVICES SOCIAUX DE PORT-CARTIER,51245132,9437,861,392,5.8308926154,7941,3.1484050078,8664,674,338,4.7949462014,7180,3.3024963634,773,169,60,17.442069498,761,1.6945601548,187,54
2024-2025,8,09,Côte-Nord,CISSS DE LA CÔTE-NORD,CENTRE MULTISERVICES DE SANTÉ ET DE SERVICES SOCIAUX DES ESCOUMINS,51218733,6771,993,264,4.273497719,5849,1.9850229384,5942,678,221,3.5321588784,5043,2.0445684888,829,48,3,9.5871712907,806,1.6124569203,315,43
2024-2025,8,09,Côte-Nord,CISSS DE LA CÔTE-NORD,CLSC ET HÔPITAL LE ROYER,51228765,14631,2159,902,9.1836078076,12593,3.8894471135,10900,933,463,5.9403212029,8870,4.5285595954,3731,960,375,18.658768352,3723,2.3667697794,1226,439
2024-2025,8,09,Côte-Nord,CISSS DE LA CÔTE-NORD,HÔPITAL ET CLSC DE SEPT-ÎLES,51232023,13907,1694,1105,8.7283647723,10447,4.6252089382,9640,711,456,5.9757623041,6306,5.2122248652,4267,734,123,14.94704014,4141,3.7312890069,983,649
2024-2025,8,11,Gaspésie-Îles-de-la-Madeleine,CISSS DE LA GASPÉSIE,CENTRE MULTISERVICES DE SANTÉ ET DE SERVICES SOCIAUX DE GRANDE-VALLÉE,51247732,4702,939,110,2.2309926036,3542,1.1876132442,4465,839,106,1.9522293144,3320,1.2166940261,237,16,3,7.4827988748,222,0.7527114615,100,4
2024-2025,8,11,Gaspésie-Îles-de-la-Madeleine,CISSS DE LA GASPÉSIE,CLSC ET CENTRE DE SERVICES AMBULATOIRES DE MURDOCHVILLE,51221307,1354,197,57,3.4441976448,1298,1.7852561633,1318,182,57,3.358735247,1262,1.8088869079,36,1,0,6.5730709877,36,0.956867284,15,0
2024-2025,8,11,Gaspésie-Îles-de-la-Madeleine,CISSS DE LA GASPÉSIE,CLSC ET CENTRE DE SERVICES AMBULATOIRES DE PASPÉBIAC,51220978,9040,1627,322,3.9769519113,8390,1.9249686134,6604,1004,249,3.1821808752,6030,2.0308168878,2436,76,7,6.131577495,2360,1.6545173023,623,73
2024-2025,8,11,Gaspésie-Îles-de-la-Madeleine,CISSS DE LA GASPÉSIE,HÔPITAL DE CHANDLER,51227775,11143,1867,396,5.1375712954,9539,2.433978055,9674,1252,315,4.2079057841,8081,2.5954623671,1469,94,0,11.259820551,1458,1.5389473784,615,81
2024-2025,8,11,Gaspésie-Îles-de-la-Madeleine,CISSS DE LA GASPÉSIE,HÔPITAL DE GASPÉ,51220903,9470,1476,374,5.417102898,8078,1.7501696652,7498,864,213,3.7065668623,6155,2.009438758,1972,223,22,11.920956446,1923,0.9203198128,612,161
2024-2025,8,11,Gaspésie-Îles-de-la-Madeleine,CISSS DE LA GASPÉSIE,HÔPITAL ET CLSC DE SAINTE-ANNE-DES-MONTS,51247799,9114,1579,386,5.4757562236,8139,2.2033066784,7186,934,246,3.401499482,6229,2.3756364496,1928,289,71,13.206881195,1910,1.6412950844,645,140
2024-2025,8,11,Gaspésie-Îles-de-la-Madeleine,CISSS DE LA GASPÉSIE,HÔPITAL ET GROUPE DE MÉDECINE DE FAMILLE UNIVERSITAIRE DE MARIA,51227908,11544,2031,590,6.5025797432,10463,2.3346826383,8641,1046,283,4.1693114223,7569,2.6171633197,2903,488,62,13.447730126,2894,1.5958795017,985,307
2024-2025,8,11,Gaspésie-Îles-de-la-Madeleine,CISSS DES ÎLES,HÔPITAL DE L'ARCHIPEL,51227783,10594,1541,330,4.763346024,9132,1.9734108081,8581,1004,165,3.4068617359,7147,2.0885444942,2013,186,33,10.545756196,1985,1.5588715365,537,165
2024-2025,8,12,Chaudière-Appalaches,CISSS DE CHAUDIÈRE-APPALACHES,CHSLD ET HÔPITAL PAUL-GILBERT,51245199,27216,2349,320,2.7561833419,21157,2.1142269304,27171,2334,319,2.7565431076,21112,2.1179363895,45,0,0,2.5389567901,45,0.3739135802,15,1
2024-2025,8,12,Chaudière-Appalaches,CISSS DE CHAUDIÈRE-APPALACHES,HÔPITAL DE MONTMAGNY,51245223,23637,3637,768,4.4743903978,21812,1.6636415352,18838,2019,435,2.763477973,17018,1.929701819,4799,508,27,11.190407955,4794,0.719166377,1618,333
2024-2025,8,12,Chaudière-Appalaches,CISSS DE CHAUDIÈRE-APPALACHES,HÔPITAL DE SAINT-GEORGES,51228971,29244,5339,1397,6.6388827623,24145,2.6725016106,20692,2257,668,4.419626278,15636,3.4150923083,8552,1001,57,12.008486969,8509,1.3079290229,3082,729
2024-2025,8,12,Chaudière-Appalaches,CISSS DE CHAUDIÈRE-APPALACHES,HÔPITAL DE THETFORD,51245231,26317,4382,812,6.0786268804,23791,2.2328250762,21150,2457,435,4.2638431048,18629,2.5366417205,5167,848,70,13.507052825,5162,1.1363895346,1925,377
2024-2025,8,12,Chaudière-Appalaches,CISSS DE CHAUDIÈRE-APPALACHES,HÔTEL-DIEU DE LÉVIS,51227569,49889,9912,3421,8.8885866457,44195,1.7780915702,34216,3957,1590,3.9091280476,28531,2.3059007357,15673,4272,1551,19.759329668,15664,0.8167200623,5955,1831
2024-2025,8,13,Laval,CISSS DE LAVAL,HÔPITAL DE LA CITÉ-DE-LA-SANTÉ,51228757,58946,11323,3903,10.652122286,45276,3.7998543747,37017,3515,826,6.5310918332,23453,4.889410535,21929,5461,502,17.608581052,21823,2.6289172611,7808,3077
2024-2025,8,14,Lanaudière,CISSS DE LANAUDIÈRE,HÔPITAL DE LANAUDIÈRE ET CENTRE D'HÉBERGEMENT PARPHILIA-FERLAND,51244945,47505,8528,3295,9.5163718614,37368,2.8563608346,30542,2604,2255,5.6905511445,20522,3.8767591555,16963,4179,614,16.404788789,16846,1.613299316,5924,1040
2024-2025,8,14,Lanaudière,CISSS DE LANAUDIÈRE,HÔPITAL PIERRE-LE GARDEUR,51228062,50892,9412,2935,10.507495317,35211,4.2393927561,34435,3280,972,5.875443065,18805,5.031710922,16457,5692,692,20.199706491,16406,3.3312162894,6132,1963
2024-2025,8,15,Laurentides,CISSS DES LAURENTIDES,CENTRE MULTISERVICES DE SANTÉ ET DE SERVICES SOCIAUX D'ARGENTEUIL,51245306,13814,1898,466,7.8819815043,10689,3.7747939211,11416,1110,317,5.6866348643,8300,4.3253054217,2398,605,130,18.333223056,2389,1.8621754802,788,149
2024-2025,8,15,Laurentides,CISSS DES LAURENTIDES,CENTRE MULTISERVICES DE SANTÉ ET DE SERVICES SOCIAUX DE RIVIÈRE-ROUGE,51217628,9012,1130,459,7.0166833111,7666,3.328710685,6864,598,231,4.6763636364,5570,3.5417267106,2148,400,87,14.495246741,2096,2.7626327926,532,228
2024-2025,8,15,Laurentides,CISSS DES LAURENTIDES,CENTRE MULTISERVICES DE SANTÉ ET DE SERVICES SOCIAUX DE SAINTE-AGATHE,51246874,21144,3975,1277,10.860980499,16343,4.1942454296,14058,1607,410,6.5133429957,9314,5.320985792,7086,2129,328,19.486310448,7029,2.7012222775,2368,867
2024-2025,8,15,Laurentides,CISSS DES LAURENTIDES,HÔPITAL DE MONT-LAURIER,51217610,12221,1830,556,8.8962806053,10046,3.261311246,9164,967,272,5.9297622945,7030,3.5590898925,3057,744,181,17.789042725,3016,2.5672184461,863,284
2024-2025,8,15,Laurentides,CISSS DES LAURENTIDES,HÔPITAL DE SAINT-EUSTACHE,51228864,34286,7133,1995,12.376690089,25012,3.6841963524,20382,1963,437,6.9181364412,11203,5.2885181797,13904,4621,1016,20.378433504,13809,2.3826381345,5170,1558
2024-2025,8,15,Laurentides,CISSS DES LAURENTIDES,HÔPITAL DE SAINT-JÉRÔME,51228880,39662,7282,3802,14.836577945,29783,4.081769242,22976,2291,1063,6.4543832816,13193,5.4244540876,16686,6040,2847,26.378547535,16590,3.0140151028,4991,2739
2024-2025,8,16,Montérégie,CISSS DE LA MONTÉRÉGIE-CENTRE,HÔPITAL CHARLES-LE MOYNE,51233799,48821,9153,3997,10.746602105,28818,5.2194402033,33548,3571,1477,6.2724578299,13561,6.0386376373,15273,5549,602,20.574310621,15257,4.4913064677,5582,2520
2024-2025,8,16,Montérégie,CISSS DE LA MONTÉRÉGIE-CENTRE,HÔPITAL DU HAUT-RICHELIEU,51229045,38434,6973,2383,12.198165123,27427,4.7763461998,26786,2744,765,6.8842638256,15838,6.0658258619,11648,4129,1962,24.418130795,11589,3.0140907086,4229,1618
2024-2025,8,16,Montérégie,CISSS DE LA MONTÉRÉGIE-EST,HÔPITAL HONORÉ-MERCIER,51229193,30168,6102,1759,10.196519491,22032,5.0844635076,16607,2195,679,6.3136173334,8633,6.6604008199,13561,2694,460,14.951578567,13399,4.0690842393,3907,1080
2024-2025,8,16,Montérégie,CISSS DE LA MONTÉRÉGIE-EST,HÔPITAL PIERRE-BOUCHER,51229011,37238,8190,2331,12.726111581,27196,5.1460803059,17519,2484,718,6.7184322101,7683,6.9330583756,19719,4840,1477,18.063529041,19513,4.4424800133,5706,1613
2024-2025,8,16,Montérégie,CISSS DE LA MONTÉRÉGIE-EST,HÔTEL-DIEU DE SOREL,51229102,24101,4179,1168,8.0781391044,19887,2.9700673388,16551,1751,379,4.5341646023,12409,3.3770751068,7550,1790,244,15.847188374,7478,2.2946782785,2428,789
2024-2025,8,16,Montérégie,CISSS DE LA MONTÉRÉGIE-OUEST,HÔPITAL ANNA-LABERGE,51229151,23537,5124,1593,16.498862205,19046,1.9973546647,13666,1350,342,8.5550512627,9177,3.5590669306,9871,4166,1785,27.496746952,9869,0.5451474032,3774,1251
2024-2025,8,16,Montérégie,CISSS DE LA MONTÉRÉGIE-OUEST,HÔPITAL BARRIE MEMORIAL / BARRIE MEMORIAL HOSPITAL,51228005,14359,1560,281,6.6431894244,11987,3.4025623824,12322,974,229,4.8429643682,9955,3.5098335566,2037,516,103,17.532916053,2032,2.8770286527,586,52
2024-2025,8,16,Montérégie,CISSS DE LA MONTÉRÉGIE-OUEST,HÔPITAL DU SUROÎT,51229136,25983,4678,2216,12.229836015,20264,2.4142145896,15044,1150,1132,4.5966980376,9754,3.2543371665,10939,3212,1658,22.727406883,10510,1.6345232847,3528,1084
